Gg, Gg, Gll^Fp, Gg, Gll^Fp, Gll^Fp, Gll^Fp, Gll^Fp, Gll^Fp, Gll^Fp, Gll^Fp, Gg, Gg, Gg, Gll^Fp, Gll^Fp, Gll^Fp, Gg, Gll^Fp, Gg, Gll^Fp, Gg, Gg, Gg, Gg, Gg, Gg
Gll^Fp, Gll^Fp, Gll^Fp, Gll^Fp, Gll^Fp, Gll^Fp, Gll^Fp, Gll^Fp, Gll^Fp, Gll^Fp, Gll^Fp, Gll^Fp, Gll^Fp, Gll^Fp, Gll^Fp, Gll^Fp, Gll^Fp, Gll^Fp, Gll^Fp, Gll^Fp, Gll^Fp, Gll^Fp, Gll^Fp, Gll^Fp, Gg, Gg, Rrc
Gll^Fp, Gll^Fp, Gll^Fp, Gll^Fp, Gll^Fp, Gll^Fp, Gll^Fp, Gll^Fp, Gll^Fp, Gll^Fp, Gll^Fp, Gll^Fp, Gll^Fp, Gll^Fp, Gll^Fp, Gll^Fp, Gll^Fp, Gg, Gll^Fp, Gll^Fp, Gll^Fp, Gll^Fp, Gg, Gll^Fp, Gg, Rrc, Gg
Gg, Gll^Fp, Gll^Fp, Gll^Fp, Gll^Fp, Gll^Fp, Gll^Fp, Gll^Fp, Gll^Fp, Gll^Fp, Gll^Efm, Gll^Fp, Gll^Fp, Gll^Fp, Gll^Fp, Gll^Fp, Gll^Fp, Gll^Fp, Gll^Fp, Gll^Fp, Gll^Fp, Gll^Fp, Gll^Fp, Rr^Vhc, Rrc, Rrc, Gg
Gg, Gll^Fp, Gll^Fp, Gll^Fp, Gg^Efm, Gll^Fp, Gll^Fp, Gll^Fp, Gll^Fp, Gll^Fp, Gll^Fp, Gll^Fp, Gll^Fp, Gll^Fp, Gll^Fp, Gll^Fp, Gll^Fp, Gll^Fp, Gll^Fp, Gll^Fp, Gg, Gll^Fp, Gll^Fp, Gll^Fp, Rrc, Gg, Gg
Gll^Fp, Gll^Fp, Gll^Fp, Gg^Efm, Gll^Fp, Gll^Efm, Gll^Fp, Gll^Fp, Gg^Ve, Gll^Fp, Gll^Fp, Gll^Fp, Gll^Fp, Gll^Fp, Gll^Fp, Gll^Fp, Gll^Fp, Gll^Fp, Gll^Fp, Gll^Fp, Gg, Gll^Fp, Rrc, Rrc, Gll^Fp, Gg, Gg
Gll^Fp, Gll^Fp, Gll^Fp, Gll^Fp, Gll^Fp, Gll^Fp, Gll^Fp, Gll^Fp, Cvr, Cvr, Gll^Fp, Gll^Fp, Gll^Fmw, Gll^Fp, Gll^Fp, Gll^Fp, Gll^Fp, Gll^Fp, Gll^Fp, Gll^Fp, Gll^Fp, Gg, Rrc, Gll^Fp, Gll^Fp, Gll^Fp, Gg
Gll^Fp, Gll^Fp, Gll^Fp, Gll^Efm, Gll^Fp, Gll^Fp, Gll^Fp, Gg^Fet, 3 Kvr, Cvr, Gg^Ve, Gll^Efm, Gll^Fmw, Gll^Fp, Gll^Fp, Gll^Fp, Gll^Fp, Gll^Fp, Gll^Fp, Gll^Fp, Gll^Fp, Gll^Fp, Gg, Gg, Gll^Fp, Gll^Fp, Gg
Gg, Gll^Fp, Gll^Fp, Gll^Fp, Gll^Fp, Gll^Fp, Gll^Fp, Cvr, Cvr, Cvr, Gll^Fp, Gll^Efm, Gll^Fmw, Gll^Fmw, Gll^Fp, Gll^Fp, Gll^Fp, Gll^Fp, Rrc, Rrc, Gll^Fp, Gg, Gll^Fp, Gg, Gg, Gg, Gg
Gg, Gll^Fp, Gll^Fp, Gll^Fp, Gll^Fp, Gll^Fp, Gll^Fp, Gll^Fp, Gll^Fp, Gll^Fp, Gll^Fp, Gll^Efm, Gll^Fmw, Gll^Fp, Gll^Fp, Gll^Fp, Gll^Fp, Rrc, Gll^Fmw, Gll^Fmw, Gg, Rrc, Gg, Gll^Fp, Gll^Fp, Gll^Fp, Gg
Gll^Fp, Gg^Ve, Gll^Fp, Gll^Fp, Gll^Fp, Gll^Fp, Gll^Fp, Gll^Fp, Gll^Fp, Gll^Fp, Gll^Fp, Gll^Fp, Gg, Gll^Fp, Gll^Fp, Gll^Fp, Gll^Fmw, Gg, Gll^Fp, Gll^Fp, Gll^Fp, Gg, Gg, Gll^Fp, Rr^Vhc, Gg, Gg
Gg, Gll^Fp, Gll^Fp, Gll^Fp, Ss, Gll^Fp, Gll^Fp, Gll^Fp, Ss, Ss, Ss, Gll^Fp, Gs^Vc, Gg, Gg, Gg, Gg, Gg, Gll^Fp, Gll^Fp, Gll^Fp, Rrc, Gg, Gll^Fp, Gll^Fp, Gll^Fp, Gg
Gg, Gll^Fp, Gll^Fp, Gll^Fp, Gll^Fp, Ss, Ss, Ss, Gll^Fp, Gll^Fp, Gg, Ss, Ss, Gll^Fp, Gll^Fp, Gg, Gll^Fp, Gll^Fmw, Gg, Gll^Fp, Gll^Fmw, Rrc, Gg, Gll^Fp, Gll^Fp, Gll^Fp, Gg
Gg, Gll^Fp, Gll^Fp, Gll^Fp, Gll^Fp, Gll^Fp, Gll^Fp, Gg, Gg, Gg, Gg, Gg, Gll^Fp, Gll^Fp, Gll^Fp, Gll^Fp, Gll^Fp, Gll^Fp, Rrc, Rrc, Gg, Gll^Fmw, Gg, Gg, Gg, Gg, Gg
Gll^Fp, Gll^Fp, Gll^Fp, Gll^Fp, Gll^Fp, Gll^Fp, Gll^Fp, Gll^Fp, Gll^Fp, Gll^Fp, Gll^Fp, Gll^Fp, Gll^Fp, Gll^Fp, Ss, Gll^Fp, Gll^Fp, Gll^Fmw, Rrc, Gll^Fmw, Gll^Fmw, Gll^Fmw, Gll^Fp, Gll^Fp, Gll^Fp, Gg, Gg
Gll^Fp, Gll^Fp, Gll^Fp, Gll^Fp, Gg, Gs^Vh, Ss, Gll^Fp, Gll^Fp, Gll^Fp, Gll^Fp, Ww, Ww, Ww, Gll^Fp, Gll^Fp, Gg, Gll^Fmw, Gll^Fp, Gg, Gll^Fmw, Gll^Fmw, Gll^Fp, Gll^Fp, Gll^Fp, Gg, Gg
Gll^Fp, Gll^Fp, Gll^Fp, Gll^Fp, Gll^Fp, Gg, Ss, Ss, Gll^Fp, Gll^Fp, Gll^Fp, Gll^Fp, Gll^Fp, Gll^Fp, Gll^Fp, Gll^Fp, Gg, Rrc, Gll^Fp, Gll^Fp, Gll^Fp, Gll^Fmw, Gg, Gll^Fp, Gs^Vc, Gg, Gg
Gll^Fp, Gll^Fp, Gll^Fp, Gll^Fp, Gll^Fp, Gll^Fp, Ss, Gll^Fp, Gll^Fp, Gg, Gll^Fp, Gll^Fp, Ss, Gll^Fp, Ss, Ss, Gll^Fp, Rrc, Rrc, Gll^Fp, Gg, Gg, Gll^Fp, Gll^Fp, Gll^Fp, Gg, Gg
Gll^Fp, Gg^Ve, Gll^Fp, Gll^Fp, Gll^Fp, Ss, Gll^Fp, Gll^Fp, Gll^Fp, Gll^Fp, Ss, Ss, Rp^Vhcr, Ss, Ss, Ss, Gll^Fp, Gll^Fp, Gll^Fp, Gg, Gll^Fp, Gg, Gll^Fp, Gll^Fp, Gll^Fp, Gg, Gg
Gll^Fp, Gll^Fp, Gll^Fp, Ww, Gll^Fp, Ss, Ss, Gll^Fp, Ss, Ss, Gll^Fp, Gll^Fp, Gg, Ss, Ss, Ss, Ss, Gll^Fp, Gll^Fp, Gll^Fp, Ss, Gll^Fp, Gll^Fp, Gll^Fp, Gg, Gg, Gg
Gll^Fp, Gll^Fp, Gll^Fp, Gll^Fp, Gll^Fp, Ss, Gll^Fp, Ss, Gg, Ss, Ss, Ww, Gll^Fp, Ss, Gll^Fp, Ss, Ss, Ss, Ss, Ss, Ss, Ss, Gll^Fp, Gg, Gll^Fp, Gll^Fp, Gll^Fp
Gll^Fp, Gll^Fp, Gll^Fp, Gll^Fp, Gll^Fp, Gll^Fp, Gg, Gg, Gg, Ss, Ss, Gll^Fp, Gll^Fp, Gll^Fp, Gll^Fp, Ss, Ss, Ss, Rp^Vhcr, Gll^Fp, Gll^Fp, Gll^Fp, Gg, Gg, Gll^Fp, Gll^Fp, Gll^Fp
Gll^Fp, Gll^Fp, Gll^Fp, Gg, Gll^Fp, Gll^Fp, Gll^Fp, Ss, Ss, Ss, Gg, Ss, Ss, Gll^Fp, Ce, Gll^Fp, Ss, Ss, Gll^Fp, Gll^Fp, Gll^Fp, Gll^Fp, Gll^Fp, Gll^Fp, Gll^Fp, Gll^Fp, Gg
Gll^Fp, Gll^Fp, Ss, Gll^Fp, Gll^Fp, Gll^Fp, Ss, Ss, Gll^Fp, Gll^Fp, Gd^Fetd, Gg, Ss, Ss, Ce, Ss, Ss, Ss, Ss, Ss, Ss, Gg, Gll^Fp, Gll^Fp, Gll^Fp, Gll^Fp, Gg
Gll^Fp, Gll^Fp, Gll^Fp, Ss, Ss, Gll^Fp, Gll^Fp, Gll^Fp, Gll^Fp, Gll^Fp, Gg, Ss, Ss, Gll^Fp, Ce, Ce, Ss, Gll^Fp, Gll^Fp, Gll^Fp, Ss, Ss, Ss, Gll^Fp, Gll^Fp, Gll^Fp, Gg
Gll^Fp, Gll^Fp, Gll^Fp, Gll^Fp, Ss, Ss, Ss, Ss, Ss, Gll^Fp, Ss, Gll^Fp, Ss, Ce, 2 Ke, Ce, Ss, Gll^Fp, Gll^Fp, Gll^Fp, Gll^Fp, Gll^Fp, Ss, Ss, Ss, Gll^Fp, Gg
Gll^Fp, Gll^Fp, Gll^Fp, Gs^Vh, Gg, Ss, Ss, Ss, Ww, Ss, Gll^Fp, Ss, Ss, Ce, Ce, Ss, Ss, Gd^Fetd, Gll^Fp, Gll^Fp, Gll^Fp, Ss, Gll^Fp, Ss, Gll^Fp, Ss, Gg
Gg, Gll^Fp, Gll^Fp, Gll^Fp, Gll^Fp, Ww, Ww, Ww, Gll^Fp, Gll^Fp, Gll^Fp, Ss, Ss, Ce, Gll^Fp, Ss, Ss, Ss, Ss, Gll^Fp, Gll^Fp, Gs^Vl, Gll^Fp, Gll^Fp, Gll^Fp, Ss, Gg
Gg, Gll^Fp, Ss, Ss, Ss, Gll^Fp, Ss, Gll^Fp, Ss, Ss, Ss, Ss, Ss, Gg, Ss, Gll^Fp, Ss, Ss, Ss, Gll^Fp, Gll^Fp, Gll^Fp, Gg, Gll^Fp, Gll^Fp, Ss, Gg
Gll^Fp, Gll^Fp, Gll^Fp, Gll^Fp, Gll^Fp, Ss, Gll^Fp, Ss, Gll^Fp, Gll^Fp, Ss, Ss, Ss, Ss, Gll^Fp, Ss, Gll^Fp, Gll^Fp, Ww, Gll^Fp, Gll^Fp, Gll^Fp, Gg, Gll^Fp, Gll^Fp, Gll^Fp, Gg
Gll^Fp, Gll^Fp, Gll^Fp, Ww, Gll^Fp, Gll^Fp, Gll^Fp, Ss, Gg, Gg, Gll^Fp, Ss, Ss, Rp^Vhcr, Gll^Fp, Gll^Fp, Gll^Fp, Gll^Fp, Gll^Fp, Gll^Fp, Gll^Fp, Gll^Fp, Gll^Fp, Gll^Fp, Gll^Fp, Gll^Fp, Gg
Gll^Fp, Gll^Fp, Gll^Fp, Gll^Fp, Gll^Fp, Gll^Fp, Gll^Fp, Gll^Fp, Gll^Fp, Gg, Gg, Gll^Fp, Gg, Gll^Fp, Gll^Fp, Gll^Fp, Gll^Fp, Gll^Fp, Gg, Rp^Vhcr, Gll^Fp, Gll^Fp, Gll^Fp, Gll^Fp, Gg, Ww, Ww
Gll^Fp, Gll^Fp, Gll^Fp, Gll^Fp, Hh, Hh, Gll^Fp, Gll^Fp, Gll^Fp, Gll^Fp, Gll^Fp, Gll^Fp, Gll^Fp, Gg, Gg, Gll^Fp, Gll^Fp, Gll^Fp, Gll^Fp, Gll^Fp, Gll^Fp, Gll^Fp, Gll^Fp, Gll^Fp, Ww, Ww, Ww
Gll^Fp, Gll^Fp, Ww, Hh, Rr^Vd, Hh, Hh, Gll^Fp, Gll^Fp, Gll^Fp, Gll^Fp, Gll^Fp, Gll^Fp, Gll^Fp, Gg, Gll^Fp, Gll^Fp, Gll^Fp, Gll^Fp, Gll^Fp, Gll^Fp, Gll^Fp, Gll^Fp, Gll^Fp, Gll^Fp, Ww, Ww
Gll^Fp, Gll^Fp, Gll^Fp, Hh, Hh, Hh, Gll^Fp, Gll^Fp, Gll^Fp, Gll^Fp, Gll^Fp, Gll^Fp, Gll^Fp, Gll^Fp, Gg, Gll^Fp, Gll^Fp, Gll^Fp, Gll^Fp, Gll^Fp, Gll^Fp, Gll^Fp, Gll^Fp, Gll^Fp, Gll^Fp, Ww, Ww
Gg, Ww, Gll^Fp, Gll^Fp, Hh, Gll^Fp, Gll^Fp, Gll^Fp, Gll^Fp, Gll^Fp, Gll^Fp, Gll^Fp, Gll^Fp, Gll^Fp, Gg, Gll^Fp, Gll^Fp, Gll^Fp, Gll^Fp, Gll^Fp, Gll^Fp, Gll^Fp, Gg^Fet, Gll^Fp, Gll^Fp, Ww, Gg
Gg, Gll^Fp, Gll^Fp, Gll^Fp, Gll^Fp, Gll^Fp, Ww, Ww, Gll^Fp, Ww, Gll^Fp, Gll^Fp, Gll^Fp, Gll^Fp, Ce, Gll^Fp, Gll^Fp, Gll^Fp, Gll^Fp, Gll^Fp, Gll^Fp, Gll^Fp, Gll^Fp, Gg^Ve, Gll^Fp, Gll^Fp, Gll^Fp
Gll^Fp, Gll^Fp, Gll^Fp, Gll^Fp, Gll^Fp, Gll^Fp, Gll^Fp, Gll^Fp, Gll^Fp, Gll^Fp, Gll^Fp, Gll^Fp, Ce, Ce, 1 Ke, Ce, Ce, Gll^Fp, Gll^Fp, Gll^Fp, Gll^Fp, Gll^Fp, Gll^Fp, Gll^Fp, Gll^Fp, Gll^Fp, Gll^Fp
Gll^Fp, Gll^Fp, Gll^Fp, Gll^Fp, Gll^Fp, Gll^Fp, Gll^Fp, Gll^Fp, Gll^Fp, Gll^Fp, Gll^Fp, Gll^Fp, Gg, Gg, Gg, Gg, Gg, Gll^Fp, Gll^Fp, Gll^Fp, Gg, Gll^Fp, Gg, Gll^Fp, Gll^Fp, Gll^Fp, Gg
