Gll^Fp, Gll^Fp, Gll^Fp, Gll^Fp, Gll^Fp, Gg, Hh, Gg, Gg, Gg, Gg, Gg, Gll^Fp, Gg, Gg, Gg, Gll^Fp, Gll^Fp, Gll^Fp, Gll^Fp, Gll^Fp, Gg, Wot
Gll^Fp, Gll^Fp, Mm, Gs^Fds, Mm, Mm, Hh, Hh, Gg, Gg, Gs^Fds, Gs^Fds, Gs^Fms, Gs^Fms, Gs, Gs, Gll^Fp, Gll^Fp, Gll^Fp, Gll^Fp, Gll^Fp, Wot, Wot
Gll^Fp, Gs^Fds, Gll^Fp, Mm, Hh, Hh, Gs^Fms, Gs^Fms, Gll^Fp, Gs^Fds, Gs^Fds, Gs^Fds, Gs^Fms, Gs^Fms, Gs^Fms, Gs, Gll^Fp, Gll^Fp, Gll^Fp, Gll^Fp, Gll^Fp, Wot, Wot
Gll^Fp, Gs^Fds, Gll^Fp, Hh, Gll^Fp, Gs^Fms, Gll^Fp, Gll^Fp, Gs^Fms, Gs^Fds, Gll^Fp, Gs^Fms, Gs^Fms, Gs^Fms, Gs^Fms, Rp, Gs, Gll^Fp, Gll^Fp, Gll^Fp, Wwt, Wot, Gll^Fp
Gll^Fp, Mm, Gs^Fms, Gll^Fp, Gll^Fp, Gll^Fp, Gs^Fms, Gs^Fms, Gs^Fms, Gs^Fms, Gg, Gll^Fp, Gll^Fp, Gs^Fms, Rp, Rp, Gll^Fp, Gs, Gg, Gg, Wwt, Gll^Fp, Gll^Fp
Gll^Fp, Gs^Fms, Hh, Gll^Fp, Gg, Gs^Fms, Gs^Fms, Gs^Fms, Gs^Fms, Gs^Fms, Gs, Gs, Gs, Rp, Gll^Fp, Gll^Fp, Gs^Fms, Gll^Fp, Gll^Fp, Wwt, Gll^Fp, Wot, Gll^Fp
Gll^Fp, Hh, Hh, Gg, Gll^Fp, Gg, Gg, Gg, Gs^Fds, Gs, Gs^Fms, Gll^Fp, Gll^Fp, Gs^Fds, Gs^Fds, Gs^Fds, Gs^Fds, Gs^Fms, Wog, Wog, Gll^Fp, Gll^Fp, Gll^Fp
Gg, Hh, Hh, Gs^Fms, Ss, Gll^Fp, Gll^Fp, Gs, Gll^Fp, Gs^Fms, Gs^Fms, Gs^Fms, Gs^Fms, Gs^Fds, Gs^Fms, Gs^Fms, Gs^Fms, Gs^Fms, Wog, Wog, Gll^Fp, Gll^Fp, Gll^Fp
Gg, Mm, Mm, Gs^Fms, Gs^Fms, Gll^Fp, Gll^Fp, Gs, Gll^Fp, Gs^Fms, Gs^Fms, Gs^Fms, Gs^Fms, Gs^Fms, Gs^Fms, Gll^Fp, Gll^Fp, Gll^Fp, Wwt, Wog, Wwt, Gll^Fp, Gll^Fp
Gg, Hh, Hh, Gs^Fms, Gs^Fds, Gs^Fds, Gs^Fds, Gs, Gs, Gll^Fp, Gll^Fp, Gll^Fp, Gs^Fds, Gs^Fds, Gll^Fp, Ss, Ss, Wwt, Gs^Fms, Gll^Fp, Wwt, Wwt, Wwt
Gg, Mm, Mm, Hh, Gs^Fds, Gs^Fds, Gs^Fds, Gll^Fp, Gll^Fp, Rp, Rp, Gs^Fds, Gs^Fds, Gs^Fds, Gs^Fms, Gll^Fp, Ss, Ce, 4 Ke, Ss, Ss, Ss, Wwt
Gll^Fp, Mm, Hh, Hh, Hh, Hh, Gs^Fms, Gs^Fms, Gs^Fms, Gll^Fp, Rp, Gs^Fds, Gll^Fp, Gs^Fms, Gs^Fms, Gs^Fms, Ss, Ss, Ce, Ce, Gs^Fds, Gll^Fp, Wwt
Gll^Fp, Mm, Gs^Fms, Gs^Fms, Hh, Hh, Gs^Fms, Gs^Fms, Gs^Fms, Gll^Fp, Rp, Gll^Fp, Gll^Fp, Gs^Fms, Gs^Fms, Gs^Fms, Gg, Gll^Fp, Ce, Gs^Fds, Gll^Fp, Wwt, Gg
Gll^Fp, Gll^Fp, Hh, Hh, Gs^Fms, Gs^Fms, Gs^Fms, Gs^Fms, Gs^Fms, Gs^Fms, Gs^Fms, Gg, Gs^Fms, Gll^Fp, Gs^Fms, Gg, Gs^Fds, Ce, Gs^Fms, Gll^Fp, Wog, Wog, Gg
Gg, Mm, Hh, Gs^Fms, Gs^Fms, Gs^Fms, Gs^Fms, Gs^Fms, Gs^Fms, Gs^Fms, Gs^Fms, Gs^Fms, Gs^Fms, Gs^Fms, Gs^Fms, Gs^Fms, Gll^Fp, Gs^Fms, Gs^Fms, Wog, Gs^Fms, Gs^Fms, Gs^Fms
Gg, Hh, Gs^Fms, Gs^Fms, Gs^Fms, Gs^Fms, Gs^Fms, Gs, Rp, Rp, Gs^Fms, Gs^Fms, Gs^Fms, Gs^Fms, Gs^Fms, Gs^Fms, Gs^Fds, Gs^Fds, Gs^Fms, Wwt, Gs^Fms, Gs^Fms, Gs^Fms
Gll^Fp, Hh, Gll^Fp, Gs^Fms, Gs^Fms, Gs^Fms, Gs^Fms, Gs, Gs, Gll^Fp, Gs^Fms, Gs^Fms, Gs^Fds, Gll^Fp, Gs^Fms, Gs^Fds, Gll^Fp, Gll^Fp, Wwt, Wwt, Gs^Fms, Gs^Fms, Gg
Gll^Fp, Hh, Gs^Fds, Gs^Fds, Gll^Fp, Gs^Fms, Gs^Fms, Gs^Fms, Gs, Gll^Fp, Gll^Fp, Gs^Fms, Gll^Fp, Gs^Fds, Gs^Fms, Gs^Fms, Gll^Fp, Gll^Fp, Wog, Gs^Fms, Gs^Fms, Gs^Fms, Gg
Gll^Fp, Mm, Gs^Fds, Gs^Fds, Gll^Fp, Ss, Gs^Fms, Gs^Fms, Gs^Fms, Gs, Gs, Gs, Gs^Fds, Gs^Fms, Gs^Fms, Gs^Fms, Gg, Gll^Fp, Wog, Gs^Fms, Gs^Fms, Gs^Fms, Gg
Gll^Fp, Gs^Fds, Gll^Fp, Gll^Fp, Ss, Ss, Gll^Fp, Gs^Fms, Gs^Fms, Gs^Fms, Gs^Fms, Gs, Gs^Fms, Gll^Fp, Gll^Fp, Gll^Fp, Gll^Fp, Wog, Wwt, Gll^Fp, Gll^Fp, Gll^Fp, Gll^Fp
Gll^Fp, Gll^Fp, Gll^Fp, Gll^Fp, Gs^Fms, Gs^Fms, Gs^Fms, Gll^Fp, Gs^Fms, Gs^Fms, Gs^Fms, Gs^Fms, Gs^Fms, Gs^Fms, Gs^Fms, Gs^Fms, Gs^Fms, Wog, Wwt, Gll^Fp, Ss, Gll^Fp, Gll^Fp
Gll^Fp, Hh, Gs^Fms, Gll^Fp, Gs^Fms, Gs^Fms, Gs^Fms, Gll^Fp, Gll^Fp, Gs^Fms, Gll^Fp, Gs^Fms, Gs^Fms, Gs^Fms, Gs^Fms, Gs^Fms, Gs^Fms, Wwt, Wwt, Gs^Fms, Ss, Gs^Fms, Gll^Fp
Gll^Fp, Mm, Gs^Fms, Gs^Fms, Gll^Fp, Gs^Fms, Hh, Gll^Fp, Gll^Fp, Gll^Fp, Gg, Rp, Gs, Gll^Fp, Gll^Fp, Gs^Fms, Gll^Fp, Gll^Fp, Gll^Fp, Wog, Wog, Gs^Fms, Gg
Gll^Fp, Hh, Gs^Fms, Gs^Fms, Gll^Fp, Ss, Hh, Gg, Gg, Gg, Gll^Fp, Gll^Fp, Gll^Fp, Gs, Gs, Gg, Gs^Fms, Gll^Fp, Gll^Fp, Gll^Fp, Wwt, Wog, Gg
Gll^Fp, Gll^Fp, Gll^Fp, Gll^Fp, Mm, Mm, Hh, Hh, Gll^Fp, Gll^Fp, Gs^Fms, Gs^Fms, Gs^Fms, Gll^Fp, Rp, Gs^Fms, Gs^Fms, Gs^Fms, Gll^Fp, Ss, Gs^Fms, Wog, Gg
Gll^Fp, Hh, Mm, Mm, Mm, Hh, Hh, Gll^Fp, Gll^Fp, Gll^Fp, Gs^Fms, Gg^Fet, Gs^Fms, Gll^Fp, Gs, Gs^Fms, Gs^Fms, Gs^Fms, Gll^Fp, Ss, Gs^Fms, Wwt, Gg
Gg, Cte, 3 Kte, Mm, Hh, Hh, Gs^Fms, Gll^Fp, Gll^Fp, Gll^Fp, Gll^Fp, Gs^Fms, Gll^Fp, Gll^Fp, Rp, Gll^Fp, Gs^Fds, Gs^Fds, Ss, Ss, Ss, Wwt, Gg
Gg, Mm, Cte, Cte, Mm, Gs^Fms, Gll^Fp, Gll^Fp, Gg, Gg, Gll^Fp, Gll^Fp, Gll^Fp, Gg, Gs, Gs^Fds, Gll^Fp, Gll^Fp, Gll^Fp, Ss, Ss, Wwt, Wwt
Gll^Fp, Hh, Hh, Mm, Gs^Fds, Gs^Fds, Gll^Fp, Gll^Fp, Gll^Fp, Gll^Fp, Gs^Fms, Gll^Fp, Ww^Ewf, Gll^Fp, Gg, Gll^Fp, Gll^Fp, Gll^Fp, Gs^Fms, Ss, Ss, Wwt, Wwt
Gll^Fp, Hh, Mm, Mm, Gll^Fp, Gll^Fp, Gs^Fms, Gs^Fms, Gs^Fms, Gs^Fms, Gs^Fms, Gs^Fms, Gll^Fp, Gll^Fp, Gs^Fms, Gg, Gll^Fp, Gll^Fp, Gs^Fms, Gs^Fms, Gs^Fms, Wog, Gg
Gll^Fp, Hh, Mm, Mm, Hh, Gll^Fp, Gs^Fms, Gs^Fms, Gs^Fms, Gs^Fms, Gs^Fms, Gs^Fms, Gll^Fp, Gs^Fms, Gs^Fms, Gs^Fms, Gll^Fp, Gll^Fp, Ss, Gs^Fms, Wog, Wwt, Gg
Gll^Fp, Hh, Mm, Hh, Hh, Gs^Fms, Gs^Fms, Gs^Fms, Gg, Gg, Gll^Fp, Gll^Fp, Gg, Gs^Fms, Gs^Fms, Gs^Fms, Gll^Fp, Gll^Fp, Gs^Fds, Ss, Wog, Wwt, Gs^Fms
Gg, Mm, Mm, Hh, Hh, Gs^Fms, Gs^Fms, Rp, Gll^Fp, Gll^Fp, Gs^Fms, Gll^Fp, Gll^Fp, Gg, Gs^Fms, Gll^Fp, Ww^Ewl, Gs^Fds, Gs^Fds, Wwt, Wwt, Wog, Gs^Fms
Gg, Mm, Hh, Hh, Gs^Fms, Gs^Fms, Gll^Fp, Rp, Gll^Fp, Gs^Fms, Gs^Fms, Gs^Fms, Gs^Fms, Gs^Fms, Gs^Fms, Gll^Fp, Gs^Fds, Gs^Fds, Wwt, Wwt, Gll^Fp, Gs^Fms, Gll^Fp
Gll^Fp, Hh, Hh, Gs^Fms, Gs^Fms, Gs^Fms, Gll^Fp, Rp, Gll^Fp, Gs^Fms, Gs^Fms, Gs^Fms, Gs^Fms, Gs^Fms, Gll^Fp, Gll^Fp, Gll^Fp, Ss, Wwt, Gll^Fp, Gs^Fds, Gs^Fds, Gll^Fp
Gll^Fp, Gll^Fp, Gll^Fp, Gs^Fms, Gs^Fms, Gs^Fms, Gll^Fp, Gs, Rp, Gll^Fp, Gll^Fp, Gs^Fms, Gs^Fms, Gs^Fms, Gll^Fp, Gll^Fp, Gs^Fds, Gs^Fds, Wwt, Gs^Fds, Gll^Fp, Gll^Fp, Gll^Fp
Gll^Fp, Hh, Gll^Fp, Gll^Fp, Gll^Fp, Gll^Fp, Gg, Gs, Gs, Gs, Gs, Ss, Ss, Gll^Fp, Gll^Fp, Gll^Fp, Gll^Fp, Gll^Fp, Wwt, Gll^Fp, Gll^Fp, Gll^Fp, Gll^Fp
Gg, Hh, Gll^Fp, Gll^Fp, Gg, Gg, Gll^Fp, Gll^Fp, Gll^Fp, Gll^Fp, Gll^Fp, Gs, Ss, Ss, Gll^Fp, Gll^Fp, Gll^Fp, Wwt, Gll^Fp, Gll^Fp, Gs^Fms, Gll^Fp, Gll^Fp
Gll^Fp, Hh, Gll^Fp, Gll^Fp, Gll^Fp, Gg, Gll^Fp, Gll^Fp, Gll^Fp, Gll^Fp, Gll^Fp, Gs, Gg, Gg, Gg, Gll^Fp, Ss, Wog, Wwt, Gs^Fms, Gs^Fms, Gs^Fms, Gll^Fp
Gll^Fp, Gll^Fp, Gll^Fp, Gll^Fp, Gll^Fp, Gg, Gll^Fp, Gll^Fp, Gs^Fms, Gll^Fp, Cer, Gg, Gll^Fp, Gll^Fp, Gll^Fp, Gg, Gs, Wog, Wwt, Gs^Fms, Gs^Fms, Gs^Fms, Gll^Fp
Gll^Fp, Gll^Fp, Gll^Fp, Gll^Fp, Gll^Fp, Gg, Ss, Gs^Fms, Gs^Fms, Cer, 2 Ke, Cer, Gll^Fp, Gll^Fp, Gll^Fp, Gll^Fp, Gs, Ss, Wog, Wwt, Gs^Fms, Gs^Fms, Gg
Gll^Fp, Gll^Fp, Gll^Fp, Gll^Fp, Ss, Ss, Gll^Fp, Gs^Fms, Gs^Fms, Cer, Gs^Fms, Cer, Gs^Fms, Gll^Fp, Gll^Fp, Gll^Fp, Gs, Gs^Fms, Gs^Fms, Wwt, Wwt, Gs^Fms, Gg
Gll^Fp, Gll^Fp, Gll^Fp, Gll^Fp, Ss, Gll^Fp, Gll^Fp, Gll^Fp, Gll^Fp, Gll^Fp, Gs^Fms, Gs^Fms, Gs^Fms, Gll^Fp, Gll^Fp, Gll^Fp, Rp, Gs^Fms, Gs^Fms, Wog, Wwt, Gll^Fp, Gg
Gll^Fp, Gll^Fp, Gll^Fp, Gll^Fp, Gll^Fp, Gll^Fp, Gll^Fp, Gll^Fp, Gll^Fp, Gll^Fp, Gll^Fp, Gs^Fms, Gg, Gll^Fp, Gg, Gg, Gll^Fp, Ss, Gg, Wog, Gll^Fp, Wog, Gg
Gll^Fp, Gll^Fp, Ss, Gll^Fp, Gll^Fp, Gll^Fp, Gll^Fp, Gll^Fp, Gll^Fp, Gll^Fp, Gll^Fp, Gll^Fp, Gll^Fp, Gg, Gll^Fp, Gll^Fp, Gll^Fp, Gll^Fp, Gll^Fp, Gll^Fp, Gll^Fp, Wwt, Gll^Fp
Gg, Gll^Fp, Gll^Fp, Gll^Fp, Gll^Fp, Gll^Fp, Gll^Fp, Gll^Fp, Ww^Ewl, Ww^Ewl, Gll^Fp, Gll^Fp, Gll^Fp, Rp, Gll^Fp, Gll^Fp, Gll^Fp, Gll^Fp, Gll^Fp, Gll^Fp, Gll^Fp, Wwt, Gll^Fp
Gg, Gll^Fp, Gll^Fp, Gll^Fp, Gll^Fp, Gll^Fp, Gll^Fp, Gll^Fp, Gll^Fp, Gll^Fp, Gll^Fp, Gll^Fp, Gll^Fp, Rp, Gll^Fp, Gll^Fp, Gll^Fp, Gll^Fp, Ww^Ewf, Ww^Ewf, Gll^Fp, Wwt, Gll^Fp
Gg, Ww^Ewf, Ww^Ewf, Gll^Fp, Gll^Fp, Gll^Fp, Gll^Fp, Gll^Fp, Gll^Fp, Gll^Fp, Gll^Fp, Gll^Fp, Gg, Rp, Gg, Gll^Fp, Gll^Fp, Gll^Fp, Gll^Fp, Gll^Fp, Gll^Fp, Wwt, Gg
Gg, Gll^Fp, Gll^Fp, Gll^Fp, Gll^Fp, Gll^Fp, Gll^Fp, Gll^Fp, Gll^Fp, Gll^Fp, Gll^Fp, Gll^Fp, Gll^Fp, Rp, Gll^Fp, Gll^Fp, Gll^Fp, Gll^Fp, Gll^Fp, Gll^Fp, Gll^Fp, Wwt, Gg
Gg, Gll^Fp, Gll^Fp, Gll^Fp, Gll^Fp, Gll^Fp, Gll^Fp, Gll^Fp, Gll^Fp, Gll^Fp, Gll^Fp, Gll^Fp, Gll^Fp, Gg, Gll^Fp, Gll^Fp, Gll^Fp, Gll^Fp, Gll^Fp, Gll^Fp, Ww, Ww, Gg
Gg, Gll^Fp, Gll^Fp, Gll^Fp, Gll^Fp, Gll^Fp, Gll^Fp, Gll^Fp, Gll^Fp, Gll^Fp, Gll^Fp, Gll^Fp, Gll^Fp, Gg, Gll^Fp, Gll^Fp, Gll^Fp, Gll^Fp, Gll^Fp, Gll^Fp, Ww, Ww, Ww
Gg, Gll^Fp, Gll^Fp, Gll^Fp, Gg, Gg, Gg, Gll^Fp, Gg, Gll^Fp, Gll^Fp, Gll^Fp, Gg, Gg, Gg, Gll^Fp, Gll^Fp, Gll^Fp, Ww, Ww, Gs, Ww, Ww
Gg, Gll^Fp, Gll^Fp, Gll^Fp, Rp, Gll^Fp, Rp, Gll^Fp, Rp, Ce, 1 Ke, Ce, Gll^Fp, Gg, Gll^Fp, Gg, Gs, Ww, Gs, Gs, Ww, Ww, Ww
Gs, Gll^Fp, Rp, Rp, Gll^Fp, Gll^Fp, Gll^Fp, Rp, Gll^Fp, Gll^Fp, Ce, Ce, Gll^Fp, Gll^Fp, Gg, Gg, Ww, Ww, Ww, Ww, Ww, Ww, Gg
Gg, Rp, Gg, Gg, Gg, Gg, Gg, Gll^Fp, Gg, Gs, Gg, Gg, Gg, Gg, Gg, Ww, Ww, Ww, Ww, Ww, Ww, Ww, Gg
