Gll^Fp, Gll^Fp, Gll^Fp, Gll^Fp, Gll^Fp, Gg, Hh, Gg, Gg, Gg, Gg, Gg, Gll^Fp, Gg, Gg, Gg, Gll^Fp, Gll^Fp, Gll^Fp, Gll^Fp, Gll^Fp, Gg, Wot
Gll^Fp, Gll^Fp, Mm, Gs^Fds, Mm, Mm, Hh, Hh, Gg, Gg, Gs^Fds, Gs^Fds, Gs^Fms, Gs^Fms, Gs, Gs, Gll^Fp, Gll^Fp, Gll^Fp, Gll^Fp, Gll^Fp, Wot, Wot
Gll^Fp, Gs^Fds, Mm, Mm, Hh, Hh, Gs^Fms, Gs^Fms, Gll^Fp, Gs^Fds, Gs^Fds, Gs^Fds, Hh^Vhh, Gs^Fms, Gs, Gs, Gll^Fp, Gll^Fp, Gll^Fp, Gll^Fp, Gll^Fp, Wot, Wot
Gll^Fp, Mm, Mm, Hh, Hh, Hh, Gll^Fp, Gll^Fp, Gs^Fms, Gs^Fds, Gll^Fp, Gs^Fms, Gs^Fms, Gs, Gs^Fms, Rp, Gs, Gll^Fp, Gll^Fp, Gll^Fp, Wwt, Wot, Gll^Fp
Gll^Fp, Mm, Hh, Hh, Gll^Fp, Gll^Fp, Gs^Fms, Gs^Fms, Gs^Fms, Gs^Fms, Gg, Gll^Fp, Gll^Fp, Gs^Fms, Rp, Rp, Gll^Fp, Gs, Gg, Gg, Wwt, Gll^Fp, Gll^Fp
Gll^Fp, Mm, Hh, Hh, Hh, Gs^Fms, Gs^Fms, Gs^Fms, Gs^Fms, Gs^Fms, Gs, Gs, Ss, Rp, Wwt, Gll^Fp, Ss, Gll^Fp, Ss, Wwt, Gll^Fp, Wot, Gll^Fp
Gll^Fp, Mm, Mm, Hh, Gll^Fp, Hh, Gg, Gg, Gs^Fds, Gs, Gs^Fms, Gll^Fp, Ss, Ss, Ss, Gs^Fds, Gs^Fds, Ss, Wog, Wog, Gll^Fp, Gll^Fp, Gll^Fp
Gg, Hh, Hh, Gs^Fms, Ss, Gll^Fp, Gll^Fp, Gs, Gll^Fp, Gs^Fms, Gs^Fms, Gs^Fms, Gs^Fms, Ss, Ss, Ss, Ss, Ss, Wog, Wog, Gll^Fp, Gll^Fp, Gll^Fp
Gg, Mm, Mm, Gs^Fms, Gs^Fms, Gll^Fp, Gll^Fp, Gs, Gll^Fp, Gs^Fms, Gs^Fms, Gs^Fms, Ss, Ss, Gll^Fp, Ss, Wwt, Gll^Fp, Ww^Vm, Wog, Wwt, Gll^Fp, Gll^Fp
Gg, Hh, Hh, Gs^Fms, Gs^Fds, Hh, Hh, Gs, Gs, Gll^Fp, Gll^Fp, Ss, Ss, Ss, Gll^Fp, Ss, Ss, Gs^Fms, Gs^Fms, Gll^Fp, Wwt, Wwt, Wwt
Gg, Mm, Mm, Hh, Gd^Vo, Hh, Hh, Gll^Fp, Ss, Rp, Rp, Gs^Fds, Ce, Ss, Ss, Gll^Fp, Ss, Gs^Fms, Wog, Ss, Ss, Ss, Wwt
Gll^Fp, Mm, Hh, Hh, Hh, Hh, Gs^Fms, Hh, Ss, Ss, Rp, Ce, 4 Ke, Ce, Gs^Fms, Ss, Ss, Wwt, Gs^Fds, Gs^Fds, Gs^Fds, Gll^Fp, Wwt
Gll^Fp, Mm, Gs^Fms, Mm, Hh, Gs^Fms, Hh, Ss, Ss, Ss, Rp, Ce, Ce, Ce, Ss, Ss, Wog, Gll^Fp, Gs^Fds, Gs^Fds, Gll^Fp, Wwt, Gg
Wog, Gll^Fp, Wog, Hh, Gs^Fms, Gs^Fms, Gs^Fms, Ss, Ss, Ss, Wwt, Ss, Wwt, Ss, Wog, Wog, Ss, Wog, Wog, Gll^Fp, Wog, Wog, Gg
Wog, Gs^Fms, Gs^Fms, Gs^Fms, Gs^Fms, Gs^Fms, Gs^Fms, Gs^Fms, Gs^Fms, Gs^Fms, Gs^Fms, Wwt, Ss, Wog, Ss, Ss, Ss, Ss, Ss, Wog, Gs^Fms, Gs^Fms, Gs^Fms
Gg, Hh, Gs^Fms, Gs^Fms, Ss, Ss, Ss, Ss, Ss, Ss, Ss, Ss, Ss, Ss, Gs^Fms, Ss, Gs^Fds, Ss, Gs^Fms, Wwt, Gs^Fms, Gs^Fms, Gs^Fms
Gll^Fp, Hh, Gll^Fp, Gs^Fms, Gs^Fms, Ss, Gs^Fms, Rp, Gs, Gll^Fp, Gs^Fms, Gs^Fms, Gs^Fds, Ss, Ss, Gs^Fds, Gll^Fp, Gll^Fp, Wwt, Wwt, Gs^Fms, Gs^Fms, Gg
Gll^Fp, Hh, Gs^Fds, Gs^Fds, Gll^Fp, Gs^Fms, Gs^Fms, Gs^Fms, Rp, Gll^Fp, Gll^Fp, Gs^Fms, Gll^Fp, Gs^Fds, Wwt, Gs^Fms, Wwt, Gll^Fp, Wog, Gs^Fms, Gs^Fms, Gs^Fms, Gg
Gll^Fp, Mm, Gs^Fds, Gs^Fds, Gll^Fp, Ss, Gs^Fms, Gs^Fms, Gs^Fms, Rp, Rp, Gs^Vh, Gs^Fds, Gs^Fms, Gs^Fms, Wwt, Wog, Gll^Fp, Wog, Gs^Fms, Gs^Fms, Gs^Fms, Gg
Gll^Fp, Gs^Fds, Gll^Fp, Gll^Fp, Ss, Ss, Gll^Fp, Gs^Fms, Gs^Fms, Gs^Fms, Gs^Fms, Gs, Gs^Fms, Gll^Fp, Ss, Ss, Gll^Fp, Wog, Wwt, Gll^Fp, Ss, Gll^Fp, Gll^Fp
Gll^Fp, Gll^Fp, Gll^Fp, Gll^Fp, Gs^Fms, Gs^Fms, Gs^Fms, Gll^Fp, Gs^Fms, Gs^Fms, Gs^Fms, Gg, Gs^Fms, Gs^Fms, Gs^Fms, Ss, Ss, Wog, Wwt, Ss, Ss, Ss, Gll^Fp
Gll^Fp, Hh, Gs^Fms, Gll^Fp, Gg, Gs^Fms, Gs^Fms, Gll^Fp, Gll^Fp, Gs^Fms, Gll^Fp, Gll^Fp, Gs^Fms, Gs^Fms, Gll^Fmf, Gs^Fms, Gs^Fms, Wwt, Wwt, Gs^Fms, Ss, Ss, Gll^Fp
Gll^Fp, Mm, Gs^Fms, Gd^Vo, Gg, Gg, Hh, Gll^Fp, Gll^Fp, Gll^Fp, Rp, Rp, Gs^Fms, Gll^Fp, Gll^Fp, Gll^Fmf, Gll^Fp, Gll^Fp, Gll^Fp, Wog, Wog, Ss, Gg
Gll^Fp, Hh, Gs^Fms, Mm, Mm, Gg, Hh, Gg, Rp, Rp, Gll^Fp, Gll^Fp, Gll^Fp, Gll^Fmf, Gs^Fms, Hh^Fmf, Gs^Fms, Gll^Fp, Gll^Fp, Gll^Fp, Wwt, Wog, Gg
Gll^Fp, Gll^Fp, Mm, Mm, Mm, Mm, Hh, Hh, Gll^Fp, Rp, Gs^Fms, Gs^Fms, Hh^Fms, Hh^Fms, Gs^Fms, Hh, Gs^Fms, Wwt, Gll^Fp, Ss, Gs^Fms, Wog, Gg
Gll^Fp, Mm, Mm, Mm, Mm, Hh, Hh, Gll^Fp, Gll^Fp, Gll^Fp, Gs^Fms, Hh^Fet, Hh, Hh^Fp, Wog, Hh^Vhh, Wwt, Wwt, Gll^Fp, Ss, Wog, Wwt, Gg
Gg, Cte, 3 Kte, Cte, Hh, Hh, Hh, Gll^Fp, Rp, Gll^Fp, Gll^Fp, Gs^Fms, Hh^Fp, Wog, Gs^Fms, Wog, Hh, Gs^Fds, Ss, Ss, Ss, Wog, Gg
Gg, Mm, Cte, Cte, Hh, Hh, Hh, Rp, Gll^Fp, Gll^Fp, Gll^Fp, Hh^Fp, Gll^Fp, Gs^Fms, Gs^Fms, Gll^Fmf, Hh^Fp, Gll^Fp, Hh^Fp, Ss, Ss, Wog, Wwt
Gll^Fp, Hh, Hh, Hh, Gs^Fds, Hh, Mm, Rp, Gll^Fp, Gll^Fp, Gs^Fms, Gll^Fp, Ww^Ewf, Gll^Fp, Gg, Gll^Fp, Gll^Fp, Gll^Fp, Gs^Fms, Ss, Ss, Wog, Wwt
Gll^Fp, Hh, Mm, Mm, Gd^Vo, Mm, Gs^Fms, Gg, Gs^Fms, Gs^Fms, Gs^Fms, Gs^Fms, Gll^Fp, Gll^Fp, Gs^Fms, Wwt, Wwt, Gll^Fp, Gs^Fms, Gs^Fms, Gs^Fms, Wog, Gg
Gll^Fp, Hh, Mm, Mm, Mm, Mm, Gs^Fms, Gll^Fp, Gs^Fms, Gll^Fdf, Gs^Fms, Gs^Fms, Gll^Fp, Gll^Fdf, Gs^Fms, Gs^Fms, Gll^Fp, Wog, Ss, Gs^Fms, Wog, Wwt, Gg
Gll^Fp, Hh, Mm, Hh, Hh, Gs^Fms, Gs^Fms, Gg, Gg, Gg, Gll^Fp, Gll^Fp, Gg, Gll^Fdf, Gs^Fms, Gs^Fms, Gll^Fp, Wwt, Wwt, Ss, Hh, Wwt, Gs^Fms
Gg, Mm, Mm, Hh, Hh, Gs^Fms, Gs^Fms, Gll^Fp, Gll^Fp, Gll^Fdf, Gs^Fms, Gll^Fp, Gll^Fp, Gg, Gs^Fms, Gll^Fp, Ww^Ewl, Gs^Fds, Gs^Fds, Wwt, Wwt, Wog, Gs^Fms
Gg, Mm, Hh, Hh, Gs^Fms, Gs^Fms, Gll^Fp, Rp, Rp, Gs^Fms, Gs^Fms, Gs^Fms, Gs^Fms, Gs^Fms, Gs^Fms, Gll^Fp, Gs^Fds, Gs^Fds, Wwt, Wwt, Gll^Fp, Gs^Fms, Gll^Fp
Gll^Fp, Hh, Hh, Gs^Fms, Gs^Fms, Gs^Fms, Gll^Fp, Gll^Fdf, Rp, Gs^Fms, Gs^Fms, Gs^Fms, Gs^Fms, Gs^Fms, Gll^Fp, Gll^Fp, Gll^Fp, Ss, Wwt, Gll^Fp, Gs^Fds, Gs^Fds, Gll^Fp
Gll^Fp, Gll^Fp, Gll^Fp, Gs^Fms, Gs^Fms, Gs^Fms, Gll^Fp, Gs, Rp, Gll^Fp, Gll^Fp, Gs^Fms, Gs^Fms, Gs^Fms, Gll^Fp, Gll^Fp, Gs^Fds, Gs^Fds, Wwt, Gs^Fds, Gll^Fp, Gll^Fp, Gll^Fp
Gll^Fp, Hh, Gll^Eqp, Gll^Fp, Gll^Fp, Gll^Fp, Gg, Gs, Gs^Eqp, Gs^Eqp, Gs^Eqp, Ss, Ss, Gll^Fp, Gll^Fp, Gll^Fp, Gll^Fp, Gll^Fp, Wwt, Gll^Fp, Gll^Fp, Gll^Fp, Gll^Fp
Gg, Hh^Eqp, Gll^Fp, Gll^Eqp, Gg, Gg, Gll^Eqp, Gll^Eqp, Rd, Gg, Gg, Gs^Eqp, Ss^Eqp, Ss, Gll^Fp, Gll^Fp, Gll^Fp, Wwt, Gll^Fp, Gll^Fp, Gs^Fms, Gll^Fp, Gll^Fp
Gll^Fp, Gll^Fp, Gll^Fp, Gll^Fp, Rd, Gg, Rd, Rd, Rd, Rd, Rd, Gd^Vhr, Rd, Gg^Eqp, Gll^Eqp, Gll^Fp, Ss, Wog, Wwt, Gs^Fms, Gs^Fms, Gs^Fms, Gll^Fp
Gll^Fp, Gll^Fp, Gll^Fp, Gll^Fp, Rd, Rd, Rd, Rd, Rd, Rd, Cer, Rd, Rd, Gd^Vhr, Gll^Fp, Gll^Eqp, Gll^Eqp, Wog, Wwt, Gs^Fms, Gs^Fms, Gs^Fms, Gll^Fp
Gll^Fp, Gll^Fp, Gll^Fp, Gll^Fp, Gll^Fp, Rd, Rd, Rd, Rd, Cer, 2 Ke, Cer, Gll^Fp, Gll^Fp, Gll^Eqp, Gll^Fp, Gll^Eqp, Ss, Wog, Wwt, Gs^Fms, Gs^Fms, Gg
Gll^Fp, Gll^Eqp, Gll^Eqp, Gd^Vhr, Ss, Rd, Rd, Rd, Rd, Cer, Gs^Fms, Cer, Gs^Eqp, Gll^Eqp, Gll^Fp, Gll^Eqp, Gll^Fp, Gs^Fms, Gs^Fms, Wwt, Wwt, Gs^Fms, Gg
Gll^Fp, Gll^Fp, Gll^Fp, Gll^Eqp, Ss^Eqp, Rd, Gll^Fp, Rd, Rd, Rd, Gg, Gs^Fms, Gs^Fms, Gll^Fp, Gll^Fp, Gll^Fp, Gll^Fp, Gs^Fms, Gs^Fms, Wog, Wwt, Gll^Fp, Gg
Gll^Fp, Gll^Fp, Gll^Fp, Gll^Fp, Gll^Fp, Gll^Eqp, Gll^Eqp, Gll^Fp, Gll^Eqp, Gll^Eqp, Gll^Fp, Gg, Gg, Gll^Fp, Gg, Gg, Gll^Fp, Ss, Gg, Wog, Gll^Fp, Wog, Gg
Gll^Fp, Gll^Fp, Ss, Gll^Fp, Gll^Fp, Gll^Fp, Hh, Gll^Eqp, Gll^Fp, Gll^Fp, Gll^Fp, Gll^Fp, Gll^Fp, Gg, Gll^Fp, Gll^Fp, Gll^Fp, Gll^Fp, Gll^Fp, Gll^Fp, Gll^Fp, Wwt, Gll^Fp
Gg, Gll^Fp, Gll^Fp, Gll^Fp, Gll^Fp, Gll^Fp, Hh, Hh, Ww^Ewl, Ww^Ewl, Gll^Fp, Gll^Fp, Gll^Fp, Rp, Gll^Fp, Gll^Fp, Gll^Fp, Gll^Fp, Gll^Fp, Gll^Fp, Gll^Fp, Wwt, Gll^Fp
Gg, Gll^Fp, Gll^Fp, Gll^Fp, Hh, Hh, Hh^Fp, Gll^Fp, Gll^Fp, Gll^Fp, Gll^Fp, Gll^Fp, Gll^Fp, Rp, Gll^Fp, Gll^Fp, Gll^Fp, Gll^Fp, Ww^Ewf, Ww^Ewf, Gll^Fp, Wog, Gll^Fp
Gg, Ww^Ewf, Hh^Ewf, Gll^Fp, Hh^Fp, Hh^Fp, Hh, Hh^Fp, Gll^Fp, Gll^Fp, Gll^Fp, Gll^Fp, Gg, Rp, Gg, Gll^Fp, Gll^Fp, Gll^Fp, Gs^Vht, Gll^Fp, Gll^Fp, Wog, Gg
Gg, Gll^Fp, Hh, Hh, Hh, Hh^Fp, Gll^Fp, Hh^Fp, Gll^Fp, Gll^Fp, Gll^Fp, Gll^Fp, Gll^Fp, Rp, Gll^Fp, Gll^Fp, Gll^Fp, Gll^Fp, Gll^Fp, Gll^Fp, Gll^Fp, Wog, Gg
Gg, Gll^Fp, Gll^Fp, Hh, Gll^Fp, Gll^Fp, Gll^Fp, Gll^Fp, Gll^Fp, Gll^Fp, Gll^Fp, Gll^Fp, Gll^Fp, Gg, Gll^Fp, Gll^Fp, Gll^Fp, Gll^Fp, Gll^Fp, Gll^Fp, Ww, Wog, Gg
Gg, Gll^Fp, Gll^Fp, Gll^Fp, Gll^Fp, Gll^Fp, Gll^Fp, Gll^Fp, Gll^Fp, Gll^Fp, Gll^Fp, Gll^Fp, Gll^Fp, Gg, Gll^Fp, Gll^Fp, Gll^Fp, Gll^Fp, Gll^Fp, Gll^Fp, Wog, Wog, Ww
Gg, Gll^Fp, Gll^Fp, Gll^Fp, Gs^Vh, Gg, Gg, Gll^Fp, Gg, Gll^Fp, Gg, Gg, Gg, Gg, Gg, Gll^Fp, Gll^Fp, Gll^Fp, Ww, Ww, Wog, Wog, Ww
Gg, Gll^Fp, Gll^Fp, Gll^Fp, Rp, Gll^Fp, Rp, Gll^Fp, Rp, Gll^Fp, 1 Ke, Ce, Gll^Fp, Gg, Gll^Fp, Gg, Gs, Ww, Gs, Gs, Wog, Ww, Ww
Gs, Gll^Fp, Rp, Rp, Gll^Fp, Gll^Fp, Gll^Fp, Rp, Gll^Fp, Ce, Ce, Ce, Gll^Fp, Gll^Fp, Gg, Gg, Gg, Ww, Wog, Wog, Ww, Ww, Gg
Gg, Rp, Gg, Gg, Gg, Gg, Gg, Gll^Fp, Gg, Gs, Gg, Gg, Gg, Gg, Gg, Gg, Ww, Ww, Ww, Wog, Ww, Ww, Gg
