Wog, Wog, Wog, Wog, Wog, Wog, Wog, Wog, Wog, Wog, Wog, Wog, Wog, Wog, Wog, Wog, Wog, Wog, Wog, Wog, Wog, Wog, Wog, Wog, Wog, Wog, Wog, Wog, Wog, Wog, Wog, Wog, Wog, Gg
Wog, Wog, Wog, Wog, Wog, Wog, Wog, Wwg, Wog, Wog, Wog, Wwrt, Wog, Wog, Wog, Wog, Wog, Wog, Wog, Wog, Wog, Wog, Wog, Wog, Wog, Wog, Wog, Wog, Wog, Wog, Wog, Wog, Wog, Wog
Wog, Wog, Wog, Wog, Ww^Vm, Wog, Wog, Wwg, Wog, Wog, Wog, Wwrt, Wog, Wog, Wog, Wog, Wog, Wog, Wog, Wog, Ww, Ww, Ww, Ww, Ww, Wog, Ww, Wog, Wog, Wog, Wwr, Wog, Wog, Wog
Wog, Wog, Wog, Wog, Wog, Wog, Wog, Wog, Wwrt, Wwrt, Wog, Wog, Gg, Wog, Wog, Wog, Wwr, Wog, Ww, Ww, Ds, Ww, Ds, Ds, Ds, Ww, Wog, Wog, Wwr, Ww, Ww^Vm, Wwr, Wog, Wog
Wog, Wog, Wog, Wog, Wog, Wwg, Wog, Wwrt, Wog, Wog, Wog, Gg, Wog, Ww, Ww, Wog, Wog, Wog, Ww, Ds, Gs^Ftp, Ds, Gg, Gs^Ftp, Ds, Ww, Ww, Wog, Wog, Wog, Wog, Wog, Wog, Wog
Wog, Wog, Wog, Wog, Wwg, Wwg, Wwg, Wog, Gg, Wog, Wog, Wog, Wog, Ww, Ww, Ww^Vm, Wog, Wog, Ww, Ds, Gg, Gs^Ftp, Wog, Wog, Wog, Ww, Wwr, Cme, Cme, Wog, Wog, Wog, Wog, Wog
Wog, Wog, Wog, Wog, Wwg, Wog, Wwg, Wwg, Wwrt, Wog, Wwrt, Wog, Ww, Ww, Ww, Ww, Ww, Wwr, Wog, Wog, Wog, Wog, Wog, Wog, Wog, Wog, Ww, 3 Kme, Ww, Cme, Wog, Wog, Wog, Wog
Wog, Wog, Wog, Wog, Wog, Wwg, Wog, Wog, Wwrt, Wwrt, Wog, Wwrt, Ds, Ds, Wog, Wog, Ww, Ww, Wog, Wog, Wog, Wog, Wwr, Wog, Wog, Wog, Wog, Wwr, Cme, Cme, Wwr, Wog, Wog, Wog
Wog, Wog, Cm, Wog, Ww, Wwg, Wog, Wog, Wog, Wog, Ww, Ww, Ww, Ds, Wog, Wog, Ww, Ww, Wog, Wog, Wog, Wwr, Wog, Wog, Gs^Ftp, Wog, Wog, Wog, Wog, Wog, Ww, Wog, Wog, Wog
Wog, Wog, 4 Km, Cm, Wwg, Wog, Wog, Wog, Wog, Gg, Gg, Ww, Ds, Ds, Wog, Wog, Wog, Gg, Gs^Vh, Gg, Gg, Gg, Wog, Wog, Wog, Wog, Wog, Wog, Wog, Wog, Wog, Wog, Wog, Wog
Wog, Wog, Wog, Cm, Wwg, Wog, Ww, Wog, Wog, Wog, Ww, Ww, Ds, Ds, Wog, Wog, Wog, Gg, Wog, Wog, Wog, Wog, Wog, Wog, Wog, Wog, Wog, Wog, Gg, Wog, Wog, Wog, Wog, Wog
Wog, Wog, Wog, Cm, Ww, Ww, Wog, Ww, Wog, Wog, Ww, Ds, Ds, Wog, Wog, Wog, Wog, Wog, Wog, Wog, Wog, Wog, Wog, Wog, Wog, Wog, Gg, Gg, Gs^Ft, Ds, Ds, Wog, Gs^Ft, Gs^Ft
Wog, Wog, Wog, Wog, Wog, Ww, Wog, Ww, Ds, Ds, Ds, Ds, Gs, Wog, Ds, Wog, Wog, Wog, Wog, Wog, Wwr, Wwr, Gg, Wog, Ds, Ds, Gg, Gs^Ft, Gs^Ft, Gs^Ft, Gs^Fds, Gs^Ft, Gs^Ft, Gg
Wog, Wog, Wog, Wog, Wog, Wog, Wog, Wwrt, Ww, Ds, Ds, Gg, Gs, Ds, Ds, Ds, Gg, Wog, Wog, Wwr, Gs^Ft, Gs^Ft, Gs^Ft, Ds, Gs^Ft, Gs^Ft, Gs^Ft, Gs^Ft, Gs^Fds, Gs^Ft, Gs^Fds, Gs^Ft, Gs^Ft, Gg
Wog, Wog, Wog, Ww^Vm, Wwrt, Wwrt, Wwrt, Wwrt, Wog, Ww, Ds, Gg, Gg^Efm, Gg, Gg, Gg, Gg, Ds, Ds, Wog, Gs^Ft, Gs^Ft, Gs^Ft, Gg, Gs^Ft, Gs^Ft, Gs^Ft, Gs^Ftp, Gs^Ft, Gs^Ft, Gs^Fds, Gs^Ft, Gs^Ft, Gg
Wog, Wog, Wog, Wog, Ww, Wwrt, Ds, Ww, Ds, Ww, Ds, Gg, Ds, Gg^Efm, Gg, Gg, Gg, Ds, Ds, Ds, Gg, Gs^Ft, Ce, Gg, Gs^Ftp, Gs^Ftp, Gs^Ft, Gg, Gs^Ft, Gs^Ft, Gs^Ft, Gs^Ft, Gs^Ft, Gg
Wog, Wog, Wog, Wog, Ww, Ds, Gs, Ds, Gs, Ds, Ds, Ds, Gg, Gg, Gg, Gg, Gs^Ftp, Gs^Ftp, Gg, Gg, Gs^Ftp, Ce, 2 Ke, Gs^Ftp, Gs^Ftp, Gs^Ftp, Gs^Ft, Gs^Ft, Gs^Ft, Gs^Ft, Gs^Ft, Gs^Fds, Gs^Ft, Gg
Wog, Wog, Wog, Wog, Ww, Ds, Gs, Gs, Gg, Gs, Gg, Gg, Gg, Gg, Gg^Efm, Gg, Gs^Ftp, Gs^Ftp, Gs^Ftp, Gs^Ftp, Ce, Ce, Gs^Ftp, Gs^Ftp, Gs^Ftp, Gg, Gs^Ftp, Gs^Fds, Gg^Ve, Gs^Ft, Gs^Fds, Gs^Fds, Gs^Ft, Gg
Wog, Ww^Vm, Wog, Ww, Ds, Ds, Gs, Gg, Gg, Gg, Gg, Gg, Gg^Efm, Gg^Efm, Gs^Vh, Gs^Ftp, Gs^Ftp, Gs^Ftp, Gs^Ftp, Gs^Ftp, Ce, Gg, Gs^Ftp, Gs^Ftp, Gs^Ft, Gs^Ftp, Gs^Ft, Gs^Ft, Gs^Ft, Gs^Ft, Gs^Ft, Gs^Ft, Gs^Ft, Gg
Wog, Wog, Wog, Wwrt, Ww, Ds, Ds, Ww, Ww, Ww, Gg, Gg, Gs^Ftp, Gs^Ftp, Gs^Ftp, Gs^Ftp, Gg, Gs^Ftp, Gg, Gg, Gs^Ftp, Gs^Ftp, Gs^Ft, Gs^Fds, Gs^Fds, Gs^Ft, Gs^Ftp, Gs^Ft, Gs^Fds, Gs^Fds, Gs^Ft, Gg, Gs^Ft, Gg
Wog, Wog, Wwrt, Wwrt, Wog, Ww, Ww, Ww, Ds, Ds, Gg, Gg, Gg, Gg^Efm, Gg, Gg, Gg, Gg, Gs^Ftp, Gs^Ftp, Gs^Ft, Gs^Ft, Gs^Ft, Gs^Fds, Gs^Ftp, Gs^Ftp, Gs^Ft, Gs^Ft, Gs^Fds, Gs^Ft, Gs^Ft, Gs^Ft, Gs^Ft, Gg
Wog, Wog, Wog, Wwrt, Wog, Ww, Ww, Ds, Gg, Gg, Gg, Gg, Gg^Vwm, Gs^Ftp, Gg, Gg, Gg, Gg, Gs^Ftp, Gs^Ftp, Gs^Ft, Gs^Ft, Gs^Ft, Gs^Ft, Gs^Fds, Gs^Ftp, Gs^Ft, Gs^Ft, Gs^Ft, Gg^Ve, Gs^Ft, Gs^Ft, Gs^Ft, Gs^Ft
Wog, Wog, Wog, Wog, Wwg, Wog, Ds, Ds, Gg, Gg, Gs^Ft, Gs^Ftp, Gs^Ftp, Gs^Ftp, Gs^Ft, Gs^Ft, Gg, Gg, Gg, Gs^Ft, Gs^Ft, Gs^Ft, Gs^Vh, Gs^Ft, Gs^Fds, Ww^Ewf, Gs^Ft, Gs^Ft, Gs^Ft, Ww^Ewl, Gs^Ft, Gs^Ft, Gs^Ft, Gs^Ft
Wog, Wog, Wog, Wog, Wwg, Ds, Ds, Ds, Gg, Gg, Gg, Gs^Ftp, Gs^Ftp, Gs^Ft, Gs^Ft, Gg, Gs^Ft, Gs^Ft, Gg, Gs^Ft, Gs^Ftp, Gs^Ft, Gs^Ft, Gs^Ft, Gs^Ft, Gs^Ft, Gs^Ft, Gs^Ft, Gs^Ft, Gs^Ft, Gs^Ftp, Gs^Ftp, Gs^Ft, Gs^Ft
Wog, Wog, Wog, Wog, Wog, Wwg, Ds, Ds, Gg, Gg, Gg, Gg, Gs^Ft, Gs^Ftp, Gs^Ftp, Gs^Ftp, Gg, Gs^Ft, Gs^Ftp, Gs^Ftp, Gs^Ftp, Gs^Ft, Gs^Ft, Gs^Ft, Gg^Efm, Gg^Efm, Gs^Fds, Gs^Ft, Gs^Ft, Gs^Ft, Gs^Ftp, Gs^Ftp, Ww^Ewl, Gs^Ft
Wog, Wog, Wog, Wog, Wog, Wog, Ds, Ds, Gg, Gg, Gg, Gg, Gg, Gs^Ftp, Gs^Ftp, Gg, Gs^Ftp, Gs^Ftp, Gs^Ftp, Gs^Ftp, Cv, Gs^Ftp, Gs^Ft, Gs^Ft, Gs^Ft, Gg, Gs^Ft, Gs^Fds, Gs^Ft, Gs^Ft, Ww^Ewf, Gs^Ft, Ww^Ewl, Gg
Wog, Wog, Wwrt, Wog, Wog, Ww, Ww, Ds, Ds, Ds, Gg, Gg, Gs^Efm, Gg^Vwm, Gs^Efm, Gg^Efm, Gg, Gs^Ftp, Gs^Ftp, Cv, 1 Kv, Gs^Ft, Gs^Ft, Gs^Ft, Gs^Ft, Gs^Ft, Gs^Ft, Gs^Ft, Gs^Ft, Gs^Ft, Gs^Ft, Ww^Ewl, Gg, Gg
Wog, Wog, Wog, Wwrt, Wog, Wog, Ww, Wog, Ds, Ds, Gg, Gs^Ftp, Gg, Gs^Ftp, Gg, Gs^Ftp, Gs^Ft, Gs^Ft, Gs^Ftp, Cv, Gs^Ft, Gs^Ft, Gs^Ft, Gs^Ft, Gs^Ft, Gs^Ft, Gs^Ft, Gs^Ft, Gs^Ft, Gs^Ft, Gs^Ftp, Gs^Ftp, Gs^Ft, Gg
Wog, Wog, Ww^Vm, Wog, Wog, Wog, Wog, Wog, Ds, Ds, Ds, Gg, Gg, Gg, Gs^Ft, Gs^Ft, Gs^Ft, Gs^Ft, Gs^Ft, Gs^Ft, Gs^Ft, Gs^Ft, Gs^Ft, Ww^Ewf, Gs^Ft, Gs^Ft, Gg^Ve, Gs^Efm, Gs^Ft, Gs^Ft, Gs^Ftp, Gs^Ftp, Gs^Ft, Gg
Wog, Wog, Wog, Wog, Wog, Wog, Wog, Wog, Wog, Ds, Ds, Gg, Gg, Gs^Ft, Gs^Ft, Gs^Ft, Gs^Ft, Gs^Ft, Gs^Ft, Gs^Ft, Gs^Ft, Gs^Ft, Ww^Ewf, Ww^Ewl, Ww^Ewl, Gs^Ft, Ww^Ewl, Gs^Efm, Gs^Ft, Gg, Gs^Ft, Gs^Ftp, Gs^Ft, Gs^Ft
Wog, Wog, Wog, Wog, Wog, Wog, Wog, Wog, Wog, Gg, Gg, Gg, Gg, Gs^Ft, Gs^Ft, Gs^Ft, Gs^Ft, Gs^Ft, Gs^Ft, Gs^Ft, Gg, Gs^Ftp, Gg, Gg, Gg, Ww^Ewf, Gg, Gs^Ft, Gg, Gg, Gg, Gs^Ft, Gs^Ft, Gs^Ft
