Md^Xm, Gll^Fp, Mv, Gll^Fp, Mm, Gll^Fp, Ww, Gll^Fp, Md^Xm, Gll^Fp, Md^Xm, Gll^Fp, Gll^Fp, Gll^Fp, Gll^Fp, Gll^Fp, Gll^Fp, Gll^Fp, Mm, Gll^Fp, Gll^Fp, Gll^Fp, Gll^Fp
Ql, Mm, Mm, Mm, Mm, Mm, Ww, Mm, Mm, Md^Xm, Mm, Mm, Mm, Mm, Gll^Fp, Gll^Fmf, Gll^Fmf, Gll^Fp, Mm, Mm, Gll^Fp, Mm, Gll^Fp
Mm, Mm, Mm, Mm, Ww, Ww, Mm, Mm, Mm, Mm, Gll^Fp, Mm, Gll^Fp, Gll^Fp, Gll^Fp, Gll^Fp, Gll^Fp, Mm, Gll^Fp, Gll^Fp, Gg^Fet, Gll^Fp, Gll^Fp
Gll^Fp, Gll^Fp, Gll^Fp, Mm, Ww, Mm, Gll^Fp, Gll^Fp, Gll^Fp, Gll^Fp, Gs^Fms, Gll^Fp, Gll^Fp, Gll^Fp, Gll^Fp, Gll^Fmf, Gs^Fds, Gll^Fp, Gs^Fds, Gll^Fp, Gll^Fmf, Gll^Fp, Gll^Fp
Gll^Fp, Gll^Fp, Gll^Fp, Gll^Fp, Ww, Gs^Fms, Gll^Fp, Gll^Fp, Gs^Fms, Gs^Fms, Gs^Fms, Gll^Fp, Ww^Ewf, Gg^Efm, Gll^Fp, Gs^Fds, Gll^Fp, Gs^Fms, Gs^Fds, Gll^Fmf, Gs^Fms, Gll^Fmf, Gll^Fp
Gg, Gll^Fp, Gll^Fp, Gll^Fp, Ww^Ewf, Gs^Fms, Gll^Fp, Gs^Fms, Gg^Fet, Gs^Fms, Gg^Xo, Ww^Ewf, Ww^Ewf, Ww^Ewf, Gg^Efm, Gll^Fp, Gg^Fet, Gll^Fp, Ww^Ewf, Gs^Fms, Gll^Fmf, Gs^Fds, Mm
Gll^Fp, Gll^Fp, Gll^Fp, Gll^Fp, Gll^Fp, Ww, Gs^Fms, Gs^Fms, Gg^Xo, Gg^Xo, Kh, Gg^Xo, Rrc^Xo, Rrc^Xo, Rrc^Xo, Rrc^Xo, Rrc^Xo, Gll^Fp, Gll^Fp, Gs^Fds, Gs^Fms, Gll^Fp, Gll^Fp
Gll^Fp, Gll^Fp, Gs^Fms, Gll^Fp, Gs^Fms, Ww^Ewf, Gg^Xo, Gg^Xo, Ch, Ch^Ecf, Ch, Ch, Gg^Fet, Ch, Ch, Ch^Ecf, Kh, Gg^Xo, Gg^Xo, Gll^Fp, Gll^Fp, Gs^Fms, Gll^Fp
Gll^Fp, Gll^Fp, Gs^Fms, Gll^Fp, Ww^Xo, Ww^Xo, Ww^Ewf, Cv, Cv, Ch, Gg^Fet, Gg^Fet, 1 Kv, Gg^Fet, Gg^Fet, Ch, Ch, Ch, Cv^Ecf, Gg^Xo, Gs^Fds, Gll^Fp, Gll^Fp
Gll^Fp, Gll^Fp, Gll^Fp, Gll^Fp, Ww^Xo, Cv^Ecf, Cv, Cv, Cv, Cv, Gg^Fet, Cv, Cv^Ecf, Cv, Gg^Fet, Cv, Ch, Cv, Cv, Gg^Xo, Gg^Fet, Gll^Fp, Gll^Fp
Gll^Fp, Gll^Fp, Gll^Fp, Gll^Fp, Gll^Fp, Ww^Xo, Kv, Gg^Fet, Cv, Cv, Rrc^Ecf, Cv, Cv, Cv, Rrc^Ecf, Cv, Ch, Cv, Cv, Ww^Xo, Gll^Fp, Gll^Fp, Gll^Fp
Gll^Fp, Gs^Fds, Gll^Fp, Gg^Fet, Gll^Fp, Ww^Xo, Ww^Ewf, Cv, Cv, Cv, Cv, Rrc^Ecf, Rrc, Rrc^Ecf, Cme, Cme, Km, Cme, Gg^Xo, Gg^Xo, Gll^Fp, Gll^Fp, Gll^Fp
Gll^Fp, Gs^Fms, Gs^Fds, Gll^Fp, Gs^Fds, Ww^Xo, Cv^Ecf, Cv, Rrc, Rrc, Rrc, Cv, Gg^Fet, Cv, Cv, Ww, Cme, Cme, Gs^Xo, Gll^Fp, Gll^Fp, Gs^Fms, Gll^Fp
Gll^Fp, Gll^Fp, Gs^Fds, Gs^Fms, Gs^Fds, Ww^Xo, Ww^Xo, Cv, Rrc, Gg^Fet, Rrc, Cv, Ww, Cv, Ww^Ewf, Ww, Ww^Ewf, Gs^Xo, Gll^Fp, Gg^Fet, Gs^Fms, Ww^Ewf, Gll^Fp
Ds, Gll^Fp, Ds, Gs^Fds, Ww, Gs^Fds, Gs^Fds, Ww^Xo, Gll^Bsb|, Rrc, Gs^Bsb|, Ww^Ewf, Ww^Ewf, Ww, Ww^Xo, Ww^Xo, Ww^Xo, Gll^Xo, Gs^Fms, Gll^Fp, Ds, Gs^Fms, Gll^Fp
Ww, Ds, Ww, Ww, Wo, Ww, Ww, Ww^Xo, Ww^Bsb|, Ww^Bsb|, Ww^Bsb|, Ww^Xo, Ww^Xo, Ww^Xo, Wo, Wo, Wo, Ww, Ww, Ds, Ww, Ds, Ww^Xo
Ww, Wo, Wo, Wo, Ww, Wo, Wo, Wo, Ww^Bsb|, Qxu^Bsb|, Ww^Bsb|, Wo, Wo, Wo, Wo, Wo, Ww, Wo, Wo, Ww, Wo, Ww, Ww
Ww, Ww, Gs^Fds, Gll^Fdf, Gs^Fds, Gll^Fdf, Gll^Fdf, Wo, Gs^Fds, Re, Gs^Fds, Wo, Gs^Fds, Ds, Ds, Ds, Gs^Fds, Gs^Fds, Gs^Fds, Wo, Wo, Wo, Wo
Gg, Ds, Gs^Fds, Gs^Fds, Gs^Fds, Gll^Fp, Gll^Fp, Gs^Fds, Gll^Fp, Rp, Gs^Fds, Gll^Fdf, Gll^Fp, Gll^Fdf, Gs^Fds, Gs^Fds, Gll^Fdf, Gll^Fp, Gs^Fds, Gs^Fds, Ds, Wo, Ds
Gg, Gll^Fdf, Gg, Gll^Fp, Gg, Gll^Fdf, Gg, Gll^Fp, Gg, Re, Gg, Gll^Fdf, Gg, Gs^Fds, Gg, Gs^Fds, Gg, Gs^Fds, Gg, Gs^Fds, Gg, Ds, Gg
