Gg, Gll^Fp, Mm, Gll^Fp, Mm, Gll^Fp, Gll^Fp, Gll^Fp, Gll^Fp, Gll^Fp, Gll^Fp, Gll^Fp, Gll^Fp, Gll^Fp, Gll^Fp, Gll^Fp, Gll^Fp, Gll^Fp, Mm, Gll^Fp, Gll^Fp, Gll^Fp, Gll^Fp
Mm, Mm, Mm, Mm, Mm, Mm, Mm, Gll^Fp, Gs^Fds, Gll^Fp, Mm, Mm, Gll^Fp, Mm, Gll^Fp, Gll^Fmf, Gll^Fmf, Gll^Fp, Mm, Gll^Fp, Gll^Fp, Gll^Fp, Gll^Fp
Mm, Mm, Gll^Fp, Mm, Gs^Fds, Gll^Fp, Gs^Fds, Mm, Mm, Mm, Gs^Fms, Mm, Gs^Fds, Gll^Fp, Gll^Fp, Gll^Fp, Gs^Fds, Mm, Gs^Fms, Gll^Fp, Gg^Fet, Gll^Fp, Gll^Fp
Gll^Fp, Gll^Fp, Gs^Fds, Mm, Gs^Fds, Gs^Fms, Gs^Fds, Gs^Fds, Gs^Fms, Gs^Fms, Gs^Fms, Gll^Fp, Gll^Fp, Gll^Fp, Gll^Fp, Gll^Fmf, Gs^Fds, Gs^Fms, Gs^Fds, Gll^Fp, Gll^Fmf, Gll^Fp, Gll^Fp
Gll^Fp, Gll^Fp, Gs^Fds, Mm, Gs^Fds, Gs^Fms, Gs^Fms, Gs^Fms, Gs^Fms, Gs^Fms, Gs^Fms, Gll^Fp, Ww^Ewf, Gg^Efm, Gll^Fp, Gs^Fds, Gll^Fp, Gs^Fms, Gs^Fds, Gll^Fmf, Gs^Fms, Gll^Fmf, Gll^Fp
Gg, Gll^Fp, Gll^Fp, Gs^Fds, Ww, Gs^Fms, Gll^Fp, Gs^Fms, Gg^Fet, Gs^Fms, Gll^Efm, Ww^Ewf, Ww^Ewf, Ww^Ewf, Rrc, Gll^Fp, Gg^Efm, Gll^Fp, Ww^Ewf, Gs^Fms, Gll^Fmf, Gs^Fds, Mm
Gll^Fp, Gll^Fp, Gll^Fp, Gg^Fet, Gll^Fp, Gll^Fp, Gg^Efm, Gll^Fp, Gll^Fp, Gll^Fp, Gll^Fp, Rrc, Rrc, Rrc, Cv, Rrc, Rrc, Gll^Fp, Gll^Fp, Gs^Fds, Gs^Fms, Gll^Fp, Gll^Fp
Gll^Fp, Gll^Fp, Gs^Fms, Gll^Fp, Gg^Efm, Ww^Ewf, Gg^Efm, Gg^Efm, Cv, Gg^Ecf, Cv, Rrc, Cv^Ecf, Cv, Cv, Rrc, Kv, Gg^Ecf, Gg^Efm, Gll^Fp, Gll^Fp, Gs^Fms, Gll^Fp
Gll^Fp, Gll^Fp, Gs^Fms, Gll^Fp, Gg^Ecf, Ww^Ewf, Ww^Ewf, Kv, Rrc, Gg^Fet, Rrc, Gg^Fet, 1 Kv, Gg^Fet, Rrc^Ecf, Cv, Rrc, Cv, Cv, Gll^Fp, Cv, Gll^Fp, Gll^Fp
Gll^Fp, Gll^Fp, Gll^Fp, Gll^Fp, Cv, Cv, Cv, Cv, Rrc, Rrc, Cv, Cv, Rrc, Cv, Cv, Gg^Fet, Rrc, Rrc, Cv, Cv, Gg^Fet, Gll^Fp, Gll^Fp
Gll^Fp, Gll^Fp, Gll^Fp, Gll^Fp, Gll^Fp, Ww^Ewf, Rrc, Gg^Fet, Rrc, Cv, Gg^Fet, Cv, Cv, Cv, Gg, Rrc, Rrc, Gg^Fet, Cv, Ww^Ewf, Gll^Fp, Gll^Fp, Gll^Fp
Gll^Fp, Gs^Fds, Gll^Fp, Gll^Fp, Gll^Fp, Ww^Ewf, Ww^Ewf, Rrc, Cv, Kv, Cv, Rrc, Cv, Rrc^Ecf, Rrc, Cv, Rrc, Cv, Gg^Ecf, Gg^Efm, Gll^Fp, Gll^Fp, Gll^Fp
Gll^Fp, Gs^Fms, Gs^Fds, Gll^Fp, Gg^Efm, Gll^Fp, Gll^Fp, Cv, Gg^Ecf, Rrc, Rrc, Rrc, Gg^Fet, Cv, Rrc, Ww^Ewf, Rrc, Cv, Gs^Fds, Gll^Fp, Gll^Fp, Gs^Fms, Gll^Fp
Gll^Fp, Gll^Fp, Gs^Fds, Gs^Fms, Gg^Fet, Gll^Fp, Gll^Fp, Gg^Efm, Gg^Efm, Gg^Efm, Gs^Fms, Rrc, Gs^Fds, Cv, Gs^Fds, Ww, Ww^Ewf, Cv, Gll^Fp, Gll^Fp, Gs^Fms, Ww^Ewf, Gll^Fp
Ww, Gll^Fp, Gll^Fp, Gs^Fds, Gll^Fp, Gs^Fds, Gs^Fds, Gll^Fp, Gll^Fp, Gs^Fds, Gs^Fms, Gs^Fms, Gll^Fp, Gs^Fds, Gll^Fp, Gll^Fp, Ww, Gll^Fp, Gll^Fp, Gll^Fp, Gll^Fdf, Gs^Fms, Gll^Fp
Ww, Gll^Fp, Ww, Gs^Fds, Ww, Ww, Ww, Gll^Fp, Gll^Fp, Gs^Fds, Gll^Fp, Gll^Fp, Ww, Gs^Fds, Ww, Gll^Fp, Ww, Ww, Ww, Gg^Fet, Ww, Gll^Fp, Ww
Ww, Ww, Ww, Ww, Gll^Fp, Gll^Fp, Gll^Fp, Ww, Gll^Fp, Gll^Fp, Gll^Fp, Ww, Ww, Ww, Ww, Ww, Ww, Ww, Ww, Ww, Ww, Ww, Ww
