Gll^Fp, Gs^Fds, Gll^Fp, Gg^Fet, Gll^Fp, Ww^Xo, Ww^Ewf, Cv, Cv, Cv, Cv, Rrc^Ecf, Rrc, Rrc^Ecf, Cme, Cme, Km, Cme, Gg^Xo, Gg^Xo, Gll^Fp, Gll^Fp, Gll^Fp, Hh, Gs^Fmw, Gs^Fmw, Gg, Hh
Gll^Fp, Gs^Fms, Gs^Fds, Gll^Fp, Gs^Fds, Ww^Xo, Cv^Ecf, Cv, Rrc, Rrc, Rrc, Cv, Gg^Fet, Cv, Cv, Ww, Cme, Cme, Gs^Xo, Gll^Fp, Gll^Fp, Gs^Fms, Gll^Fp, Gll^Fp, Gs^Fmw, Hh, Gll^Fp, Hh
Gll^Fp, Gll^Fp, Gs^Fds, Gs^Fms, Gs^Fds, Ww^Xo, Ww^Xo, Cv, Rrc, Gg^Fet, Rrc, Cv, Ww, Cv, Ww^Ewf, Ww, Ww^Ewf, Gs^Xo, Gll^Fp, Gg^Fet, Gs^Fms, Ww^Ewf, Gll^Fp, Hh, Gll^Fp, Gll^Fp, Ww, Gg
Ds, Gll^Fp, Ds, Gs^Fds, Ww, Gs^Fds, Gs^Fds, Ww^Xo, Gll^Bsb|, Rrc, Gs^Bsb|, Ww^Ewf, Ww^Ewf, Ww, Ww^Xo, Ww^Xo, Ww^Xo, Gll^Xo, Gs^Fms, Gll^Fp, Ds, Gs^Fms, Ww, Gll^Fp, Ww, Ww, Ww, Ww
Ww, Ds, Ww, Ww, Wo, Ww, Ww, Ww^Xo, Ww^Bsb|, Ww^Bsb|, Ww^Bsb|, Ww^Xo, Ww^Xo, Ww^Xo, Wo, Wo, Wo, Ww, Ww, Ds, Ww, Ds, Ww^Xo, Ww, Wo, Wo, Wo, Ww
Ww, Wo, Wo, Wo, Ww, Wo, Wo, Wo, Ww^Bsb|, Qxu^Bsb|, Ww^Bsb|, Wo, Wo, Wo, Wo, Wo, Ww, Wo, Wo, Ww, Wo, Ww, Ww, Wo, Wo, Wo, Wo, Wo
Ww, Ww, Gs^Fds, Gll^Fdf, Gs^Fds, Gll^Fdf, Gll^Fdf, Wo, Gs^Fds, Re, Gs^Fds, Wo, Gs^Fds, Ds, Ds, Ds, Gs^Fds, Gs^Fds, Gs^Fds, Wo, Wo, Wo, Wo, Wo, Wo, Hh^Fmf, Gll^Fp, Gs^Fmw
Gg, Ds, Gs^Fds, Gs^Fds, Gs^Fds, 6 Cvr, Gll^Fp, Gs^Fds, Gll^Fp, Rp, Gs^Fds, Gll^Fdf, Gll^Fp, Gll^Fdf, Gll^Fp, Gs^Fds, Gll^Fdf, Gll^Fp, Gs^Fds, Gs^Fds, Ds, Wo, Ds, Hh^Fmw, Ww, Wo, Wo, Ww
Wog, Gll^Fdf, Gll^Fp, Gll^Fp, Gs^Fds, Gll^Fdf, Gg^Ve, Cvr, Gg, Re, Cvr, Cvr, Rb, Gll^Fp, Gll^Fp, Gll^Fp, 1 Kvr, Cvr, Gll^Fp, Gs^Fds, Ss, Ss, Hh^Fmw, Hh^Fmw, Gs^Vc, Gs^Fmw, Hh^Fmw, Ww
Wog, Wog, Ds^Esd, Gs^Fds, Gs^Fds, Gll^Fp, Gs^Fds, Gs^Fds, Gll^Fp, Gg, Gs^Fds, Gs^Fds, Gs^Fds, Cvr, Gll^Fp, Cvr, Cvr, Cvr, Gs^Fds, Ss, Gs^Fds, Gll^Fdf, Hh, Gs^Fds, Gg^Fms, Gs^Fds, Gll^Fdf, Gg
Wog, Wog, Ds^Esd, Gs^Fds, Gs^Fds, Gs^Fp, Gs^Fds, Cvr, Gll^Fp, Rb, Gll^Fp, Gs^Fds, Hh^Fmw, Rb, Rb, Gg^Ve, Gs, Hh, Gs^Fds, Gll^Fdf, Gs^Fds, Mm^Xm, Mm^Xm, Gll^Fdf, Gs^Fp, Hh, Hh, Wwg
Wog, Wog, Ds^Esd, Gs^Fds, Gs^Fds, Ss, Gg^Em, Hh, Gg, Re, Gll^Fp, Gll^Fp, Gll^Fp, Hh^Fmw, Hh^Esa, Gg, Gg^Fet, Gg, Gll^Fdf, Gs^Fds, Gs^Fmw, Mm, Mm, Gll^Fdf, Wwg, Wwg, Wwg, Wwg
Wog, Wog, Ds^Esd, Gs^Fds, Gs^Fds, Ss, Hh^Fmw, Hh^Fmw, Re, Re, Gg, Gg, Gll^Fp, Gll^Fp, Cvr, Gll^Fp, Gll^Fp, Hh, Gs^Fds, Gs^Fmw, Gs^Fmw, Gs, Gs^Fds, Gs^Fds, Gs^Fds, Hh, Hh, Hh
Wog, Wog, Wog, Ww^Vm, Ds^Esd, Hh^Fmw, Gs, Hh, Re, Aa^Fpa, Gg, Gg, Gll^Fp, Gll^Fp, Gll^Fp, Gll^Fp, Gll^Fp, Gs^Fds, Gs^Fds, Gs^Fds, Gg, Gg, Gs^Fds, Gs^Fds, Gs^Fds, Wwg, Gs, Mm
Wog, Ds^Esd, Gs^Fds, Gs^Fds, Ds, Ss, Cvr, Gs^Fds, Rra, Gg, Gg, Gll^Fp, Gll^Fp, Cvr, Gll^Fdf, Gll^Fdf, Hh, Gs^Fds, Gll^Fp, Gs^Fds, Gg^Fet, Gs^Fp, Wwg, Gs^Fds, Wwg, Wwg, Gs^Gvs, Gs
Wog, Gs^Fds, Gs^Fds, Gs^Fds, Ds^Esd, Ss, Gs^Fds, Gs^Fds, Re, Ha, Gg^Fms, Gg, Gll^Fp, Gll^Fp, Aa^Fma, Gll^Fdf, Hh, Gll^Fp, Gll^Fdf, Gll^Fp, Gs^Fds, Gs^Fds, Ss, Wwg, Gg^Gvs, Gg^Gvs, Gg^Gvs, Gs
Wog, Wog, Gs^Fds, Gs^Fds, Gs^Fds, Ds, Gs^Fds, Gs^Fds, Gs^Fds, Re, Rra, Gs^Fmw, Ai, Aa^Fma, Gs^Fmw, Hh^Fmw, Aa, Gll^Fdf, Gll^Fp, Gll^Fp, Gs^Fds, Ss, Gs^Fds, Gs^Fds, Gs^Fds, Gg^Gvs, Gg^Gvs, Gg
Wog, Wog, Gs^Fds, Gs^Fds, Gs^Fds, Wwg, Ds^Esd, Gs^Fds, Hh, Gg, Gg, Re, Re, Hh, Gg^Gvs, Gg^Gvs, Gs^Vc, Gg, Gs^Fds, Hh, Gll^Fp, Gll^Fp, Gll^Fp, Gs^Fds, Gs^Fds, Gg^Gvs, Gg^Gvs, Gg^Gvs
Wog, Wog, Ds^Esd, Gs^Fds, Gs^Fds, Wog, Ds^Esd, Gg^Vh, Wwg, Wwg, Wwg, Gg, Hh, Re, Hh^Fmw, Gg^Gvs, Gs^Fds, Gs^Fds, Gll^Fdf, Gs^Fds, Gll^Fdf, Gll^Fp, Gll^Fp, Gs^Fds, Gg^Gvs, Gg^Vh, Gg^Gvs, Gs^Fds
Ds^Esd, Ds^Esd, Gs^Fds, Gs^Fds, Gs^Fds, Wwg, Wwg, Wwg, Wwg, Wwg, Wwg, Ai, Hh^Fmw, Re, Hh^Fmw, Wwg, Gs^Gvs, Gll^Fdf, Gll^Fdf, Gs^Fds, Gs^Fds, Gll^Fp, Ss, Gg, Gs^Fds, Gg^Gvs, Gg^Gvs, Gg^Gvs
Gs^Fds, Ds^Esd, Gll^Fp, Gll^Fp, Gll^Fp, Hh, Gll^Fdf, Wwg, Gll^Fdf, Wwg, Wwg, Ai, Gs^Fp, Rb, Hh, Ai, Ai, Gs^Fds, Gs^Esa, Ss, Gll^Fp, Gs^Fds, Ss, Gs^Fds, Gs^Fds, Gg^Gvs, Gg^Gvs, Gg
Gs^Fds, Ds^Esd, Gll^Fp, Gll^Fp, Gll^Fp, Gs^Fp, Wwg, Gll^Fdf, Wwg, Wwg, Gg, Gg^Esa, Hh^Tf, Rb^Esa, Rb, Gg, Aa^Fpa, Ha, Aa^Fda, Gll^Esa, Ai, Gs^Fds, Wwg, Gs^Fds, Gs^Fds, Gs^Fds, Gg^Gvs, Gg^Gvs
Ds^Esd, Gs^Fds, Gs^Fds, Gll^Fp, Gs^Fds, Gs^Fds, Gs^Fds, Wwg, Wwg, Wwg, Xu, Hh^Fmw, Hh^Fmw, Hh^Fmw, Rb, Gs^Esa, Aa, Aa, Xu, Aa^Fda, Ai, Wwg, Wwg, Wwg, Gg, Gg, Rb, Rb
Gs^Fds, Gs^Fds, Gll^Fp, Gg^Ve, Gs^Fds, Gs^Fds, Gs^Fds, Wwrg, Uu^Tf, Xu, Uu^Tf, Mm, Mm^Xm, Hh^Fmw, Rb^Esa, Gs^Vo, Ha, Ha, 2 Kea, Cea, Cea, Aa^Vla, Aa^Fma, Hh^Fmw, Hh^Fmw, Rb, Gg^Gvs, Wwg
Wog, Ds^Esd, Gll^Fp, Gll^Fp, Gs^Fds, Gs^Fds, Gs^Fds, Wwrg, Xu, Uh, Uu, Mm, Hh, Rb, Hh^Esa, Aa, Aa, Xu, Cea, Cea, Aa^Fma, Ai, Aa^Fma, Hh^Fmw, Gs^Fds, Rb, Gg^Gvs, Wwg
Wog, Gll^Fp, Gll^Fp, Gll^Fp, Gs^Fds, Gs^Fds, Gs^Fds, Wwrg, Gs^Fp, Gg^Em, Xu, Hh, Hh, Rb, Gg^Tf, Hh^Esa, Aa, Aa, Ai, Ai, Rb^Esa, Gs^Fds, Rb, Hh^Fmf, Hh^Fmf, Rb, Gs, Gg^Em
Wog, Gs^Fds, Gs^Fds, Gs^Fds, Wog, Gs^Fds, Wog, Wog, Gg, Hh, Mm, Gg, Rb, Rb, Hh, Gs, Gs, Aa, Hh^Fmw, Gg^Esa, Gs^Fmw, Rb, Gs, Rb, Rb, Rb, Gs, Gg
