Ms^Xm, Ms^Xm, Ms^Xm, Ms^Xm, Ms^Xm, Ms^Xm, Ms^Xm, Ms^Xm, Ms, Ms^Xm, Ms, Ms^Xm, Ms, Ms, Aa^Fpa, Ms^Xm, Ms^Xm, Ms^Xm, Xu, Ms^Xm, Xu, Xu, Xu, Xu, Xu, Xu, Xu, Qxe, Qxe, Gg, Qxe, Gg
Ms^Xm, Ms^Xm, Ms^Xm, Ms^Xm, Ms^Xm, Ms^Xm, Ms^Xm, Ms, Ms, Ms, Ms, Ms, Ms, Ms, Aa^Fpa, Rra, Ms, Ms, Xu, Qxe, Qxe, Tb^Tf, Urb, Urb, Urb, Urb, Urb, Xu, Qxe, Xu, Qxe, Uu
Ms^Xm, Ms^Xm, Ms^Xm, Ms^Xm, Ms^Xm, Ms^Xm, Ms^Xm, Ms, Ms^Xm, Ms, Ms, Ms, Ms, Ha^Vhha, Aa, Ms, Ms, Ms^Xm, Ms^Xm, Xu, Tb^Tf, Tb^Tfi, Uu, Xu, Xot, Urb, Xot, Xot, Xot, Xot, Xot, Uu
Ms^Xm, Ms^Xm, Ms^Xm, Ms^Xm, Ms^Cov, Ms^Cov, Ms^Cov, Ms^Xm, Ms^Xm, Ms, Ms, Ms, Ms, Ms, Aa^Fpa, Aa, Ms, Ms^Xm, Xu, Xot, Urb, Xot, Uu, Xot, Qxua, Qxua^Cov, 6 Qxua^Kov, Qxua, Rra, Rra, Rra, Xot
Ms^Xm, Ms^Xm, Ms^Xm, Ms, Ms^Cov, 3 Ms^Kov, Ms^Cov, Ms^Xm, Ms^Xm, Ms, Ms, Ms, Ms^Xm, Aa^Fpa, Rra, Rra, Ms, Ms^Xm, Xu, Urb, Xu, Qxe, Urb, Uu, Qxua, Qxua, Qxua^Cov, Xot, Rra, Ai, Rra, Xot
Ms^Xm, Ms^Xm, Ms^Xm, Ms^Xm, Ms, Ms^Cov, Ms, Ms, Ms, Ms, Ms, Ms, Ms^Xm, Aa, Aa, Ms, Ms, Ms^Xm, Xot, Urb, Xot, Qxe, Uu, Xot, Tb, Xot, Uhe, Xot, Xot, Rra, Xot, Xot
Ms^Xm, Ms^Xm, Ms^Xm, Ms^Xm, Ms, Ms^Xm, Ms, Ms, Ms, Ms, Ms^Xm, Ms^Xm, Ms, Aa^Fpa, Aa^Fpa, Ms, Ms^Xm, Ms^Xm, Xot, Uhe, Urb, Xu, Tb^Tfi, Xu, Uu, Xot, Uhe, Qxe, Qxe, Xot, Xu, Xu
Ms^Xm, Ms^Xm, Ms, Ms, Ms, Ms, Ms, Ms, Ms, Ms^Xm, Ms^Xm, Ms^Xm, Ms, Aa^Fpa, Aa^Fpa, Ms^Xm, Aa^Fpa, Ms^Xm, Xu, Xu, Tb^Tf, Xu, Qxe, Uu, Xu, Xu, Xu, Qxe, Qxe, Qxe, Xu, Xu
Aa, Ms^Xm, Ms, Ms, Ms, Aa, Aa^Fpa, Aa, Ms, Ms^Xm, Ms^Xm, Ms, Ms, Ms, Aa^Fpa, Rra, Aa^Fpa, Ms^Xm, Aa^Fpa, Urb^Xo, Xu, Tb^Tf, Xu, Uu, Tb^Tfi, Xu, Urb, Urb, Xu, Uhe, Tb, Uu
Aa, Ms, Ms, Ms, Ms, Aa^Fpa, Ms, Ms, Ms^Xm, Ms^Xm, Ms, Ms, Ha^Vhha, Ms, Aa^Fpa, Rra, Aa^Fpa, Aa^Fpa, Aa^Fpa, Aa^Fpa, Ms^Xm, Xu, Xu, Tb^Tf, Xot, Tb^Tf, Uu, Xu, Tb, Uu, Wwt, Uu
Aa, Ms, Ms, Ms, Ha^Vhha, Aa, Ms, Ms^Xm, Ms^Xm, Ms, Ms, Ms, Ms, Ms, Aa^Fpa, Aa^Fpa, Aa^Fpa, Aa^Fpa, Aa^Fpa, Ms, Ms, Xu, Wo, Xu, Wo, Xot, Xu, Uu, Xu, Xu, Wwt^Xo, Uu
Aa^Fpa, Ms, Aa^Fpa, Ms, Aa, Aa^Fpa, Ms, Ms^Xm, Ms, Ms, Ai, Ms, Aa, Rra, Rra, Aa, Ms, Ms, Aa^Fpa, Aa^Fpa, Ai, Ms^Xm, Ms, Wo, Ai, Wo, Wo, Xu, Wwt, Xu, Wwt, Xu
Aa^Fpa, Aa^Fpa, Aa^Fpa, Ms, Aa^Fpa, Aa^Fpa, Ms, Ms^Xm, Ms, Ai, Ai, Ai, Ms, Ms, Ms, Ms, Ms^Xm, Ms, Ms, Aa^Fpa, Aa^Fpa, Ai, Ai, Ai, Aa, Ai, Wo, Wo, Ai, Wwt, Wwt, Xu
Aa^Fpa, Aa^Fpa, Aa^Fpa, Aa, Ms, Ms, Ms, Ms, Ai, Ai, Ai, Ai, Aa^Fpa, Ms, Ms, Ms, Ms^Xm, Ms, Aa, Rrc^Vhca, Aa, Ai, Aa, Ai, Ai, Ai, Ai, Ai, Wo, Wwt, Wo, Wo
Aa^Fpa, Aa^Fpa, Aa, Ms, Ms, Ms, Ms, Aa, Aa, Ai, Aa^Fpa, Aa^Fpa, Ms, Ms, Ms^Xm, Ms^Xm, Ms^Xm, Ms^Xm, Ms, Ms, Ms, Aa, Aa, Wo, Wo, Wo, Wo, Ai, Wo, Wo, Ai, Wo
Aa^Fpa, Aa^Fpa, Aa, Aa^Fpa, Ms, Ms, Aa, Rra, Aa, Aa^Fpa, Aa^Fpa, Ms, Ms^Xm, Ms^Xm, 2 Kha, Cha, Ms, Ms^Xm, Ms^Xm, Ms, Ms, Aa, Wo, Wo, Aa, Ai, Ai, Wo, Ai, Wo, Wo, Wo
Aa^Fpa, Aa^Fpa, Aa^Fpa, Aa^Fpa, Aa^Fpa, Ms, Aa^Fpa, Rra, Ms, Ms, Ms^Xm, Ms^Xm, Ms, Cha, Cha, Ms, Rrc^Vhca, Cha, Ms^Xm, Ms, Aa^Vaa, Aa, Aa, Aa, Ai, Ai, Aa, Wo, Wo, Wo, Wo, Wo
Ms, Aa^Fpa, Ms, Aa, Aa^Fpa, Aa^Fpa, Aa^Fpa, Aa, Ms, Ms, Ms^Xm, Ms^Xm, Ms, Rrc^Vhca, Rra, Rra, Cha, Cha, Ms^Xm, Ms, Aa, Aa, Ms^Xm, Ms^Xm, Aa^Fpa, Ai, Aa, Aa, Wo, Ww^Vm, Wo, Wo
Ms, Ms, Aa^Fpa, Aa, Ms, Aa^Voa, Aa^Fpa, Aa^Fpa, Aa^Fpa, Ms, Ms, Ms^Xm, Ms^Xm, Cha, Rra, Cha, Ms, Ms^Xm, Ms, Aa, Aa, Ms^Xm, Ms^Xm, Ha, Ha, Ai, Aa^Fpa, Aa, Ai, Aa, Wo, Aa
Ms, Ms^Xm, Aa^Fpa, Ms^Xm, Ms, Ms, Aa^Fpa, Aa, Aa, Aa^Fpa, Ms, Ms, Ms^Xm, Ms^Xm, Rra^Xo, Ms^Xm, Ms^Xm, Ms^Xm, Aa, Aa, Ms, Ms, Ms, Ha, Ms, Ms, Ms, Ai, Aa, Aa, Aa, Aa
Ms, Ms, Aa^Fpa, Ms^Xm, Ms^Xm, Ms, Ms, Aa, Rra, Ms, Ms, Ms^Xm, Ms^Xm, Cha, Rra, Cha, Ms, Ms, Aa, Aa, Ms, Ms^Xm, Ms, Ms, Ha, Ai, Ai, Ai, Ha, Aa, Aa, Gg
Ms, Ms, Aa, Ms, Ms^Xm, Ms, Ms, Aa, Aa, Ms, Ms, Ms, Ms^Xm, Rra, Cha, Rra, Rra, Aa, Ai, Aa, Aa^Fpa, Aa^Fpa, Aa^Fpa, Ha, Aa, Ha, Cea, Ai, Ms, Ha, Aa, Gg
Aa^Fpa, Aa^Fpa, Aa^Fma, Ms, Ms, Ms^Xm, Ms, Aa, Rra, Ms, Ms, Ms, Ms, Ms^Xm, Ms^Xm, Rra, Ai, Ai, Ms, Ai, Ai, Aa^Fpa, Aa^Fpa, Aa, Ha, Cea, 4 Kea, Cea, Ha, Ms, Aa, Aa
Aa^Fma, Aa^Fma, Aa^Fma, Aa^Fma, Ms, Ms, Aa^Vaa, Aa, Aa, Aa, Aa, Ms, Ms, Ms, Aa, Rra, Ai, Ha, Ha, Ms, Ms, Aa^Voa, Ms, Ms, Ms, Cea, Ha, Cea, Ms, Ms, Aa, Aa
Aa^Fma, Aa^Voa, Aa^Fma, Aa^Fma, Aa, Ms, Ms, Ms, Ms, Aa, Ai, Rra, Ai, Ms, Rra, Ai, Ha, Ha, Ms, Ms, Ms^Xm, Aa^Fpa, Ms, Ms, Aa, Ha, Ms, Ms, Ms, Aa, Aa^Fpa, Gg
Aa^Fma, Aa^Fma, Ms^Xm, Ms^Xm, Aa, Cte, Cte, Ms^Xm, Ms^Xm, Ms, Ms, Ai, Ai, Aa, Ms, Aa, Ms, Ha, Ms, Ms^Xm, Ms, Ms, Aa, Aa, Ms, Ms, Ms, Ms, Ms, Aa, Aa^Fpa, Aa^Fpa
Aa, Ms^Xm, Ms^Xm, Ms, Ha, 5 Kte, Cte, Ms, Ms, Ms^Xm, Ms, Ms, Aa, Rra, Ms, Ms^Xm, Ms, Ms, Ms^Xm, Ms^Xm, Ha, Ha, Aa, Aa, Aa, Ms, Ms, Ms, Ms, Aa, Aa^Voa, Aa^Fpa
Ms, Ms^Xm, Ms, Aa^Vaa, Ha, Cte, Aa^Fpa, Ha, Ms, Aa^Voa, Ms, Ms, Aa, Ms, Aa, Ai, Ms, Ms^Xm, Ha, Ms, Ha, Ha, Ms^Xm, Ha, Aa, Ms, Ha, Ha, Ha, Ha, Aa^Fpa, Aa^Fpa
Ms, Ms^Xm, Ms, Ms, Ha, Aa^Fpa, Aa^Fpa, Ms, Ms, Ms^Xm, Ms, Ms, Ha, Aa, Rra, Aa, Ms, Ms^Xm, Aa^Fpa, Ha, Ha, Ms^Xm, Ms^Xm, Aa^Fda, Ha, Aa, Ha, Ms, Ms, Aa^Fpa, Ms, Aa^Fpa
Aa, Ms^Xm, Ms^Xm, Ms, Aa^Fpa, Aa^Fpa, Aa^Fpa, Ms, Ms, Ms^Xm, Aa^Fma, Ha, Ms, Ha, Rra, Aa, Ms, Ms^Xm, Aa^Fpa, Ha, Ms, Ha, Aa^Fda, Aa^Fda, Aa^Fpa, Aa, Ms, Ms, Ms, Ms, Ms, Gg
Aa, Ms^Xm, Ms^Xm, Ms, Ms, Ha, Ms, Ms, Ms, Aa^Fma, Aa^Fma, Aa^Fma, Aa^Fpa, Ha, Aa, Aa, Aa^Fpa, Ms, Aa^Vca, Ms, Ms, Aa, Aa^Fda, Aa^Fpa, Aa^Fpa, Aa, Aa, Ms, Ms, Ms^Xm, Ms^Xm, Ms^Xm
Aa, Ms^Xm, Ms^Xm, Ms, Ms, Aa^Fpa, Ms, Ms, Aa^Fpa, Aa^Fma, Aa^Fma, Ha, Ms, Ms, Aa^Fpa, Rra, Rra, Aa^Fpa, Aa^Fda, Aa^Fpa, Aa, Aa^Fpa, Aa^Fda, Aa^Fpa, Ms, Aa^Fpa, Aa, Aa, Aa, Ms, Ms, Ms^Xm
Aa, Ms^Xm, Ms^Xm, Ms^Xm, Ms, Aa^Fpa, Aa^Vca, Aa^Fpa, Aa^Fda, Aa^Fpa, Aa^Fpa, Ha, Aa^Fpa, Aa^Fpa, Ms^Xm, Ms, Aa, Aa^Fda, Aa^Fpa, Aa^Fpa, Aa, Aa^Fpa, Aa^Fpa, Ms^Xm, Ms^Xm, Ms^Xm, Ms, Aa^Fpa, Ms, Aa, Ms, Ms
Aa, Ms^Xm, Ms^Xm, Ms^Xm, Ms, Ms, Aa^Fpa, Aa^Fpa, Aa, Aa^Fpa, Aa, Ms, Ms^Xm, Ms^Xm, Ms, Ms, Aa, Rra, Aa^Fda, Aa, Aa^Fpa, Aa^Fda, Aa^Fpa, Aa^Fpa, Aa^Fpa, Ms, Aa^Fpa, Ms^Xm, Ms, Ms^Xm, Ms^Xm, Ms
Ms, Ms^Xm, Ms^Xm, Ms^Xm, Aa^Fpa, Ms, Aa^Fpa, Aa^Fpa, Ms^Xm, Aa, Ms, Ms^Xm, Aa, Aa, Ms, Ms, Aa, Aa^Fda, Aa^Fda, Aa, Ha, Ms, Aa, Aa^Vca, Aa^Fpa, Aa^Fpa, Aa^Fpa, Ms, Ms, Ms, Ms^Xm, Ms
Aa, Ms, Aa, Aa^Fpa, Aa^Fpa, Aa^Fpa, Ms^Xm, Aa^Fpa, Ms^Xm, Ms, Aa^Vca, Ms, Ai, Ai, Wwt, Aa, Aa, Aa^Fda, Aa^Fda, Ha, Ms, Ms, Aa, Aa, Aa, Aa^Fpa, Ha, Ms, Ms, Ms, Ms^Xm, Ms
Aa, Ms, Aa, Aa^Fma, Aa, Ms, Ms, Ms^Xm, Ms, Ms, Ms, Ai, Ai, Wwt, Aa, Ai, Aa, Ha, Ha, Ha, Ms, Ms, Ms, Aa, Ha, Aa, Ha, Ha, Ms, Ms, Ms^Xm, Ms
Aa, Aa, Ms, Ms^Xm, Ms, Aa, Ha, Ms, Ms, Ms^Xm, Ms, Ms, Ms, Ai, Rra, Aa, Ms, Ms, Ms, Ms, Ms, Ms, Aa, Ha, Ms, Ms, Ms, Aa, Aa, Ms, Ms^Xm, Ms
Aa, Ha, Ms^Xm, Ms^Xm, Ms, Aa, Aa, Ha, Ms, Ms^Xm, Ms, Ms, Ha, Aa, Rra, Ai, Ai, Ms, Ms, Ms, Ms, Ms, Ha, Ha, Ms, Ms, Ms, Ms, Aa, Ms, Ms^Xm, Gg
Aa, Ms, Ms^Xm, Ms, Aa, Ha, Aa^Fpa, Aa^Fpa, Ms, Ms^Xm, Ms, Ms, Ha, Aa, Rra, Aa, Aa, Ms, Ms, Ms, Aa^Fpa, Ha, Ms, Ms, Ms, Ms, Ms, Ms, Ha, Ms, Ms, Gg
Aa, Ha, Ms, Ms^Xm, Ms, Ha, Aa^Fpa, Aa^Fpa, Ms, Ms, Ms, Ms, Ha, Rra, Rra, Rra, Aa, Ms, Ms, Aa^Fpa, Aa^Fpa, Ha, Ms, Ms, Ms, Ha, Ms, Ms, Aa^Fpa, Ms, Gll^Fp, Gll^Fp
Aa, Ha, Ha, Ms^Xm, Ms, Ms, Ha, Aa^Fpa, Ms, Ms, Aa^Fma, Aa^Fma, Aa^Cov, Rra, Rra, Rra, Aa, Ms, Ms, Aa^Fpa, Aa^Fda, Aa^Fda, Aa^Fda, Ms, Aa^Fpa, Ms, Ms, Aa^Fpa, Aa^Fpa, Aa^Fpa, Gll^Fp, Aa^Fpa
Gll^Fp, Aa, Aa, Ms, Ms, Ms, Aa^Fpa, Aa^Fpa, Ms, Aa^Vca, Aa^Fma, Aa^Cov, 1 Aa^Kov, Aa^Cov, Aa^Fda, Rra, Aa, Aa^Vca, Aa^Fpa, Aa^Fpa, Aa^Fpa, Aa^Fda, Aa^Fpa, Aa^Fpa, Gll^Fp, Aa^Fpa, Ms, Aa^Fpa, Aa^Vea, Aa^Fpa, Gll^Fp, Gll^Fp
Gll^Fp, Gll^Fp, Aa^Fpa, Ha, Ha, Aa^Vca, Aa^Fpa, Aa^Fpa, Aa^Fpa, Aa^Fpa, Aa^Fpa, Aa^Cov, Aa^Cov, Aa^Cov, Aa^Fpa, Aa^Fpa, Aa^Fpa, Aa^Fpa, Aa^Fpa, Aa^Fda, Gll^Fp, Aa^Fda, Aa^Fpa, Aa^Fpa, Aa^Fpa, Aa^Fpa, Gll^Fp, Aa^Fpa, Aa^Fpa, Aa^Fpa, Gll^Fp, Gll^Fp
Gg, Gll^Fp, Gll^Fp, Gll^Fp, Gg, Aa^Fpa, Aa^Fpa, Aa^Fpa, Aa^Fpa, Aa^Fda, Aa^Fpa, Aa^Fpa, Aa^Fpa, Aa^Fpa, Aa^Fpa, Aa^Fpa, Aa^Fpa, Gll^Fp, Gg, Gll^Fp, Gg, Gll^Fp, Aa^Fda, Gll^Fp, Gg, Gll^Fp, Gg, Gll^Fp, Gg, Gll^Fp, Gg, Gll^Fp
