Gg, Aa, Aa, Ds, Ds, Ds, Gs^Fp, Gs^Fp, Gs^Fp, Gg, Hh, Hh, Gg, Gg, Aa, Aa, Gg, Gg, Gg, Gs^Fp, Gg, Gg, Gg, Gg, Gg, Gg, Gg, Gg, Gg, Gg, Gg, Gg, Gg, Gg, Gg, Gg, Gg, Ds, Ds, Wo, Wo, Wo
Ds, Aa, Gg, Gg, Ds, Gg, Gs^Fp, Gs^Fp, Gs^Fp, Gg, Gg, Hh, Gg, Gg, Aa, Aa, Gg, Gg, Gs^Fp, Gs^Fp, Gg, Gg, Hh, Hh, Gg, Gg, Gg, Gg, Gg, Gg, Gg, Gg, Gg, Gg, Gg, Gg^Vh, Gg, Gg, Ds, Gg, Gg, Ds
Gg, Aa, Aa, Gg, Gg, Gg, Gs^Fp, Gg^Ve, Gs^Fp, Gg, Gg, Hh, Hh, Gg, Gg, Gg, Gg, Gs^Fp, Gg, Gs^Fp, Gs^Fp, Hh, Hh, Hh, Hh, Gg, Gg, Aa, Aa, Gg, Gg, Gg, Aa, Gg, Gg, Gg, Gg, Gg, Gg, Gg, Gg, Aa
Gg, Gg, Gg, Ch, Ch, Ch, Gg, Gg, Gg, Gg, Gg, Gg, Hh, Gg, Gg, Gg, Re, Gg, Gg, Gg, Gs^Fp, Gg, Gg^Vh, Hh, Hh, Hh, Gg, Gg, Gg, Gg, Gg, Gg, Gg, Gg, Gg, Gg, Gg, Gg, Gg, Gg^Vh, Gg, Aa
Gg, Gg, Gg, Ch, 1 Kh, Ch, Gg, Gg, Re, Gg, Gg, Gg, Gg, Gg, Gg, Re, Gg, Gg, Gg, Gg, Gg, Gg, Re, Ww, Ww, Ww, Hh, Gg, Gg, Gg, Gg, Gg, Gg, Gg, Gg, Gg, Gg, Gg, Gg, Gg, Gg, Aa
Gg, Gg, Ch, Ch, Ch, Gg, Gg, Gg, Gg, Gg, Gg^Vh, Gg, Gg, Re, Re, Re, Gg, Gs^Fp, Gg, Gs^Fp, Re, Gg, Re, Hh, Ww, Ww, Ww, Ww, Gg^Vh, Gg, Gg, Gg, Gg, Gg, Gg, Gg, Gg, Gg, Gg, Gg, Gg, Gg
Aa, Aa, Aa, Aa, Aa, Rr, Rr, Gg, Gg, Gg, Gg, Gg, Gg, Re, Gg, Gg, Gs^Fp, Gg^Ve, Gs^Fp, Re, Gg, Gg, Re, Ww, Ww, Ww, Ww, Ww, Hh, Gg, Gg, Gg, Gg, Gg, Gg, Gg, Gg, Gg, Gg, Gg, Gg, Gg
Aa, Aa, Aa, Aa, Aa, Gg, Rr, Gg^Vh, Gg, Gg, Gg, Gg, Aa, Gg, Gg, Gg, Gs^Fp, Gs^Fp, Cha, Gg, Gg, Gg, Aa, Ww, Ww, Ww, Ww, Ww, Ww, Gg, Gg, Gg, Aa, Aa, Gg, Aa, Gg^Vh, Gg, Gg, Gg, Gg, Ww
Gg, Aa, Aa, Aa, Aa, Gg, Gg, Rr, Rr, Gs^Fp, Gs^Fp, Gg, Gg, Gg, Cha, Cha, Cha, Cha, Rr, Cha, Cha, Aa, Aa, Aa, Ww, Ww, Ww, Ww, Gg, Gg, Aa, Aa, Aa, Aa, Aa, Aa, Aa, Gg, Gg, Gg, Gg, Ww
Gg, Gg, Gg, Aa, Gg, Gg, Gg, Gg, Rr, Gg, Gg, Gg, Rr, Cha, Rr, Rr^Vhc, Rr, Rr, Rr^Vhc, Rr, Rr, Cha, Cha, Gg, Gg, Ww, Gg, Gg, Gg, Gg, Aa, Aa, Gg, Aa, Aa, Aa, Aa, Gg, Gg, Gg, Gg, Ww
Gg, Gg, Gg, Gg, Gg, Gg, Gg, Gg, Gg, Rr, Rr, Rr, Cha, Cha, Cha, Rr, Rr, Rr, Cha, Cha, Cha, Rr, Rr, Cha, Cha, Ww, Ww, Gg, Gg, Gg, Aa, Aa, Aa, Gg, Aa, Aa, Aa, Gg, Gg, Gg, Gg, Gg
Gs^Fp, Gs^Fp, Gg, Gg^Vh, Gg, Gg, Gg, Re, Gg, Rr, Rr, Rr, Cha, Gg, Cha, Rr, Rr^Vhc, Cha, Kh, 3 Kh, Kh, Cha, Rr^Vhc, Rr, Cha, Gs^Fp, Ww, Gs^Fp, Gg, Gg, Gg, Gg, Aa, Aa, Aa, Aa, Aa, Gg, Gg, Gg, Gg, Gg
Gs^Fp, Gs^Fp, Gg, Gg, Gg, Gg, Gg, Re, Gg, Gg, Gg, Rr, Rr, Cha, Rr^Vhc, Rr, Rr, Cha, Cha, Kh, Cha, Cha, Rr, Rr, Cha, Gg, Ww, Gg, Gg^Ve, Gs^Fp, Gg, Gg, Aa, Aa, Aa, Aa, Gg, Gg, Gg, Ww, Ww, Ww
Gs^Fp, Gs^Fp, Ds, Gg, Gg, Re, Gg, Re, Gg, Gg, Gg, Rr, Rr, Cha, Cha, Rr, Rr, Rr^Vhc, Rr, Cha, Rr, Rr, Cha, Cha, Cha, Gg, Gg, Ww, Gs^Fp, Gs^Fp, Gg, Gg, Aa, Aa, Gg^Vh, Ww, Ww, Gg, Gg, Ww, Ww, Gg
Gs^Fp, Ds, Gs^Fp, Gg, Gg, Gg, Gg, Gg, Gg, Re, Gg, Gg, Gg, Rr, Rr, Rr, Rr, Rr, Rr^Vhc, Rr, Rr, Rr, Cha, Gg, Cha, Gg, Gg, Ww, Gs^Fp, Gg, Gg, Gg, Aa, Aa, Ww, Ww, Ww, Ww, Ww, Ww, Ww, Ww
Ds, Ds, Gs^Fp, Gg, Gs^Fp, Gg, Gg, Aa, Gg, Gg, Aa, Gg, Gg, Rr^Vhc, Rr, Cha, Cha, Rr, Cha, Cha, Cha, Cha, Rr, Cha, Rr^Vhc, Gg, Gs^Fp, Ww, Gg, Gg, Gg, Gg, Gg, Ww, Gs^Fp, Ww, Ww, Ww, Ww, Gg^Vh, Ww, Gg
Ds, Gs^Fp, Gs^Fp, Gg^Vh, Gs^Fp, Gs^Fp, Aa, Aa, Aa, Aa, Aa, Gg, Gg, Rr, Rr, Gs^Fp, Rr, Cha, Cha, Gg, Cha, Cha, Rr, Ww, Ww, Ww, Ww, Ww, Ww, Gg, Re, Gg, Gg, Hh, Gg, Gs^Fp, Gs^Fp, Ww, Ww, Gg, Ww, Gg
Ds, Ds, Gg, Gs^Fp, Gs^Fp, Gs^Fp, Aa, Aa, Aa, Gs^Fp, Gs^Fp, Gg, Gg, Rr, Rr, Rr, Gg, Rr, Rr, Cha, Rr, Rr, Ww, Ww, Ww, Ww, Gg, Ww, Ww, Ww, Gg, Gg, Re, Gg, Hh, Gs^Fp, Gs^Fp, Ww, Ww, Ww, Ww, Gg
Wo, Ds, Gg, Gg, Gg, Gg, Aa, Aa, Aa, Aa, Gs^Fp, Aa, Gg, Rr, Rr, Rr, Rr, Gg, Rr, Rr, Gg, Aa, Gg, Ds, Ww, Ds, Gg, Gg, Gg, Gg, Re, Gg, Gg, Gg, Gg, Gg, Gs^Fp, Ww, Ww, Ww, Gg, Gg
Wo, Ds, Ds, Gg, Gg, Gg, Aa, Gg, Aa, Aa, Aa, Gs^Fp, Gg, Gg, Rr, Rr, Rr, Rr, Rr, Rr, Rr, Gg, Gg, Gg^Vh, Ww, Ds, Ds, Ds, Ds, Ds, Gg, Gg, Re, Gg, Gg, Gs^Fp, Gs^Fp, Ww, Ww, Ww, Gs^Fp, Gg
Wo, Wo, Ds, Ds, Ds, Aa, Aa, Aa, Gg, Aa, Gs^Fp, Gg, Gg^Vh, Gg, Gg, Rr, Rr, Rr, Gg, Rr, Rr, Rr, Rr, Ds, Ds, Wo, Wo, Wo, Wo, Ds, Ds, Gg, Gg, Gg, Gg, Gg, Re, Gs^Fp, Gs^Fp, Gs^Fp, Gs^Fp, Gg
Ds, Ds, Ds, Ds, Ds, Ds, Ds, Aa, Aa, Gs^Fp, Gg, Gg, Gg, Gg, Gg, Gg, Re, Gg, Gs^Fp, Gs^Fp, Gs^Fp, Rr, Gg, Aa, Ds, Ds, Wo, Wo, Wo, Wo, Ww, Ds, Ww, Gg, Gg, Gg, Gg, Gg, Gs^Fp, Gg^Vh, Gs^Fp, Gg
Gg, Gg, Gg, Ds, Wo, Wo, Ai, Aa, Gg, Gg, Gg, Gg, Gg, Re, Re, Gg, Gg, Gs^Fp, Gg^Ve, Gs^Fp, Gs^Fp, Rr, Gg, Aa, Aa, Aa, Aa, Gg, Ds, Ds, Ds, Ww, Ww, Gs^Fp, Gg^Vh, Gg, Gg, Gg, Gg, Gs^Fp, Gg, Gg
Gg, Gg^Vh, Gs^Fp, Ds, Ds, Wo, Wo, Ds, Ds, Gg, Re, Gg, Gg, Gg, Ds, Ds, Ds, Gs^Fp, Gs^Fp, Gg^Ve, Gg, Rr, Rr, Aa, Aa, Aa, Aa, Gg^Vh, Gg, Gg, Gg, Gg, Gg, Ww, Ww, Gg, Gg, Gg, Gg, Gg, Gg, Gg
Gs^Fp, Gs^Fp, Gs^Fp, Gg, Ds, Ds, Wo, Ds, Ds, Gg, Gg, Gg, Gg^Vh, Gg, Ds, Ds, Ds, Gg, Gs^Fp, Gg, Gg, Rr, Rr, Rr, Rr, Gg, Gg, Gg, Gg, Gg, Gs^Fp, Gg, Gs^Fp, Gg, Ww, Gg, Ww, Gg, Gg, Gg, Gg^Vh, Gg
Gs^Fp, Gs^Fp, Gs^Fp, Gg, Ds, Ds, Wo, Wo, Ds, Ds, Ds, Ds, Ds, Ds, Ds, Ds, Ds, Gg, Gg, Gg, Gg, Gg, Gg, Rr, Rr, Rr, Gg, Gg, Gs^Fp, Gs^Fp, Gs^Fp, Gs^Fp, Gg, Gg, Gg, Ww, Ww, Ds, Gg, Ds, Gg, Gg
Gs^Fp, Gg^Ve, Gs^Fp, Gg, Ds, Ds, Wo, Wo, Wo, Ds, Ds, Ds, Ds, Ds, Wo, Ds, Gg, Gg, Re, Re, Re, Re, Gg, Gg^Vh, Rr, Rr, Rr, Gg, Gg, Gs^Fp, Gg, Gg, Gg, Gg, Re, Gg^Vh, Ww, Gg, Ds, Ds, Ds, Ds
Gs^Fp, Gs^Fp, Gs^Fp, Gg, Gg, Ds, Wo, Wo, Wo, Wo, Wo, Wo, Wo, Wo, Wo, Ai, Ww, Gg^Vh, Gg^Vh, Gg, Gg, Gg, Gg, Gg, Gg, Rr, Rr, Rr, Rr, Gg, Gg, Gg, Re, Re, Gg, Gg, Gg, Ww, Ds, Ds, Ds, Ds
Gg, Gs^Fp, Gs^Fp, Gg, Gg, Ds, Wo, Wo, Wo, Wo, Wo, Wo, Wo, Wo, Ds, Ai, Ww, Gg, Gg, Gg, Gg, Gg, Gg, Gg, Gg, Gs^Fp, Gg, Rr, Rr, Rr, Rr, Gg, Gg, Gg, Gg, Gg, Gg, Ww, Gg, Ds, Gg, Gg
Hh, Gs^Fp, Gg, Gg, Gg, Gg, Ds, Ds, Ds, Ds, Ds, Ds, Ds, Aa, Aa, Ww, Aa, Gg, Gg, Gg, Gg, Gg, Gg, Gg, Gg, Gg, Gg, Gg, Rr, Rr, Rr, Gs^Fp, Gs^Fp, Gs^Fp, Gs^Fp, Gs^Fp, Ww, Ww, Ww, Gg, Gg, Gg
Gg, Gs^Fp, Gg, Gg, Gg, Gg, Gg, Gg, Ds, Ds, Gg, Gg, Gg, Gg, Gg, Ww, Ww, Aa, Gg, Gg, Gg, Gg, Gg, Gs^Fp, Gs^Fp, Gg, Gg, Gg, Gs^Fp, Rr, Rr, Gs^Fp, Gs^Fp, Gs^Fp, Gs^Fp, Gg, Ww, Ww, Ww, Gg, Gg, Gg
Gs^Fp, Gs^Fp, Gg, Gg^Vh, Gg, Gg, Gg, Gg, Gg, Gg, Gg, Gg, Gg, Gg^Vh, Ww, Ww, Ww, Ww, Gg^Vh, Gg, Gg, Gg, Gs^Fp, Gs^Fp, Gs^Fp, Gg, Gg, Gg, Gs^Fp, Gs^Fp, Gs^Fp, Rr, Gs^Fp, Gs^Fp, Gs^Fp, Gs^Fp, Gs^Fp, Gg, Ww, Gg, Gg, Gg
Gg, Gs^Fp, Gg, Gg, Gg, Gg, Gg, Gg, Gs^Fp, Gs^Fp, Gg, Gg, Gg, Ww, Ww, Ww, Ww, Ww, Ww, Gg, Gg, Gg, Gg, Gg, Gs^Fp, Gs^Fp, Gg, Gg, Gg, Gs^Fp, Gs^Fp, Rr, Gg^Vh, Gg, Gs^Fp, Gg, Gs^Fp, Gg, Ww, Gg, Gg, Gg
Gg, Gs^Fp, Gg, Gg, Gg, Gg, Re, Gg, Gs^Fp, Gs^Fp, Gg, Gg, Gg, Ww, Ww, Ww, Ww, Ww, Ww, Gg^Vh, Gg, Gg, Gg, Gg, Gg, Gg, Gg, Gs^Fp, Gg, Gg, Gg, Rr, Rr, Gg, Gg, Gg, Gs^Fp, Gs^Fp, Ww, Gs^Fp, Gg, Gg
Gg, Gs^Fp, Gg, Gg, Re, Gg, Gs^Fp, Gs^Fp, Gg, Gg, Gg, Gg, Gg, Gg^Vh, Hh, Ww, Ww, Gg^Vh, Gg, Gg, Gg, Gg, Gg, Gg, Gg, Gg, Gs^Fp, Gs^Fp, Gs^Fp, Gg, Gg, Gg, Rr, Gg, Gs^Fp, Gg, Gg, Gs^Fp, Ww, Ww, Ww, Gg
Gg, Gg^Vh, Gg, Gg, Gg, Gs^Fp, Gs^Fp, Gg, Gg, Gg, Gg, Gg, Gg, Gg, Gg, Hh, Aa, Gg, Gg, Gg, Gg, Gg, Gg, Gg, Gg, Gs^Fp, Gs^Fp, Gg^Ve, Gs^Fp, Gs^Fp, Gg, Ch, Ch, Ch, Gg, Gg, Gg, Gg, Gs^Fp, Gs^Fp, Gg, Ww
Gg, Gg, Gg, Gg, Gg, Gg, Gg, Aa, Gg, Gg, Gg, Gg, Gg, Gg, Aa, Aa, Aa, Aa, Gg, Gg, Gg, Gg, Gg, Gg, Gg, Gg, Gs^Fp, Gg, Gg, Gg, Gs^Fp, Ch, 2 Kh, Ch, Gg, Gg, Gg, Gg, Gg, Gs^Fp, Gg, Ww
Gg, Aa, Gg, Gg, Gg^Vh, Gg, Aa, Aa, Aa, Gg, Gg, Gg, Gg, Gg, Aa, Aa, Aa, Aa, Gg, Gg, Gg^Vh, Gg, Gg, Gg, Gg, Gg, Gg, Gg, Gg, Gg, Ch, Ch, Ch, Gg, Gg, Hh, Gg, Gg, Gg, Gg, Gg, Ww
Gg, Gs^Fp, Gs^Fp, Hh, Hh, Aa^Fpa, Aa, Aa, Aa, Aa^Vha, Aa, Gg, Gg, Gg, Aa, Aa, Aa, Aa, Gg, Gg, Gg, Gg, Gg, Gg, Gg, Gg, Gg, Gg, Gg, Gg, Rr, Rr, Rr, Gg, Gg, Gg, Gg, Gg, Gg, Gg, Ww, Ww
Gg, Gs^Fp, Gs^Fp, Gg, Hh, Aa^Fpa, Aa, Aa, Aa, Aa^Fpa, Gg, Gg, Gg, Gg, Aa^Fpa, Aa, Aa, Aa, Gg, Aa, Aa, Aa, Aa, Aa, Aa, Gg, Gg, Gg, Rr, Rr, Rr, Rr, Gg, Gg, Gg, Gg, Gg, Gg, Gg, Gg, Ww, Ww
Gg, Gs^Fp, Gs^Fp, Gs^Fp, Gs^Fp, Aa, Aa, Aa^Fpa, Aa, Gg, Gg, Gg, Gg, Gg, Gg, Aa^Fpa, Gg, Gg, Gg, Aa, Aa, Aa, Aa, Aa, Aa, Gg, Gg, Rr, Rr, Rr, Gg, Gg, Gg^Ve, Gg, Gs^Fp, Gg, Gg, Gg, Gg, Gg, Gg^Vh, Ww
Gs^Fp, Gs^Fp, Gg, Gs^Fp, Aa, Aa, Gg, Gg, Aa, Aa, Gg, Gg, Gg, Aa, Aa, Gg, Gg, Gg, Gg, Gg, Gg, Gg, Gg, Aa, Aa, Gg, Gg, Rr, Gg, Rr, Gg, Gs^Fp, Gs^Fp, Gs^Fp, Gs^Fp, Gs^Fp, Gs^Fp, Gs^Fp, Gs^Fp, Gs^Fp, Gg, Ww
