Rr, Aa, Aa, Ds, Ds, Ds, Gs^Fp, Gs^Fp, Gs^Fp, Gg, Hh, Hh, Gg, Gg, Aa, Aa, Gg, Gg, Gs^Fp, Gs^Fp, Gg, Gg, Ww, Gg, Gg, Gg, Gg, Gg, Gg, Gg, Re, Gg, Gg, Gg, Gg, Gg, Gg, Ds, Ds, Wo, Gll^Fp, Wo, Aa^Fpa, Aa, Xue, Gg, Gll^Fp, Gg, Xue, Gg, Xue
Ds, Rr, Rr, Gg, Ds, Gg, Gs^Fp, Gs^Fp, Gs^Fp, Gg, Gg, Hh, Gg, Gg, Aa, Aa, Gs^Fp, Gs^Fp, Gs^Fp, Gs^Fp, Gg, Ww, Hh, Ww, Gg, Gg, Gg, Gg, Re, Re, Gg^Gvs, Gg^Gvs, Gg^Gvs, Gg^Gvs, Gg^Gvs, Gg^Wm, Gg, Gg, Re, Re, Aa^Fpa, Hh, Hh, Hh, Xue, Gll^Fp, Cer, Gll^Fp, Hh, Gll^Fp, Xue
Gg, Aa, Aa, Rr, Gg, Gg, Gs^Fp, Gs^Fp, Gs^Fp, Gg, Gg, Hh, Hh, Gg, Gg, Gg, Gs^Fp, Gs^Fp, Gs^Fp, Gs^Fp, Gs^Fp, Hh, Hh, Ww, Ww, Gg, Re, Re, Gg^Gvs, Gg^Gvs, Gg^Gvs, Gg^Gvs, Aa, Gg^Gvs, Gg^Gvs, Gg^Gvs, Gg^Gvs, Re, Re, Re, Aa^Fpa, Aa^Fpa, Re, Xue, Gll^Fp, Cer^Fp, Ww, Hh, Ww, Hh, Gg
Gg, Gg, Gg, Rr, Ce, Gg, Gg, Gg^Gvs, Gg, Gg, Gg^Vh, Gg, Hh, Gg, Gg, Gs^Fp, Gs^Fp, Gs^Fp, Gs^Fp, Gg, Gs^Fp, Gg, Gg^Vh, Hh, Ww^Bsb/, Ww^Bsb/, Gg^Gvs, Re, Re, Re, Re, Gg, Gg^Vh, Gg, Gg^Gvs, Gg^Gvs, Re, Re, Gg, Gg^Vh, Gll^Fp, Re, Xue, Re, Cer, Ww, Cer, Cer, Cer, Uu^Vu, Gg
Gg, Gg, Gg, Ce, 1 Ke, Ce, Gg, Gg^Gvs, Gg^Gvs, Gg^Gvs, Gg^Gvs, Gg^Gvs, Gg^Gvs, Gg, Gg, Gg, Gg, Gs^Fp, Gg, Gs^Fp, Gg, Gg, Re, Ww^Bsb/, Ww, Ww, Hh, Gg^Gvs, Gg^Gvs, Gg^Gvs, Gg^Gvs, Re, Re, Gg^Gvs, Re, Re, Gg^Gvs, Gg, Gg^Gvs, Gll^Fp, Gg^Gvs, Aa^Fpa, Xue, Aa^Fpa, Cer^Fp, Hh, Cer^Fp, Ker, Hh, Hh, Xue
Gg, Gg, Gg, Ce, Ce, Rr, Gg^Gvs, Gg^Gvs, Gg^Gvs, Gg^Gvs, Gg^Gvs, Gg^Gvs, Gg^Gvs, Re, Re, Re, Re, Gg, Gg, Gg, Re, Gg, Re, Hh, Ww, Ww, Ww, Ww, Gg^Gvs, Gg^Gvs, Gg^Gvs, Gg^Gvs, Gg^Gvs, Re, Gg^Esa, Gg, Gg^Gvs, Gg^Esa, Gg^Gvs, Gg^Gvs, Gg^Gvs, Gg^Gvs, Gg^Gvs, Gll^Fp, Re, Hh, Ww, Cer^Fp, Ww, Hh, Xue
Gg, Gg, Aa, Aa, Aa, Rr, Gg^Gvs, Gg^Gvs, Gg^Gvs, Gg^Gvs, Gg^Gvs, Gg^Gvs, Gg^Gvs, Re, Gg, Gg, Re^Xo, Re, Gg^Xo, Re, Gg, Gg, Re, Ww, Ww, Ww, Ww, Ww, Hh, Gg^Gvs, Gg^Gvs, Gg^Gvs, Gg, Re, Re, Gg^Esa, Gg^Esa, Gg^Esa, Gg^Gvs, Gg^Gvs, Gg^Gvs, Gg^Gvs, Re, Re, Ww^Fp, Xue, Hh, Ww, Ww^Fp, Uu^Vu, Xue
Aa, Aa, Aa, Aa, Aa, Rr, Rr, Gg^Vh, Gg, Gg^Gvs, Gg, Gg^Gvs, Gg, Gg, Gg^Xo, Gg^Xo, Gg^Xo, Gg^Xo, Cha, Gg^Xo, Gg^Xo, Gg, Aa, Ww, Ww, Ww, Ww, Ww, Ww, Gg^Gvs, Gg^Gvs, Gg^Gvs, Aa, Aa, Re, Aa, Gg, Gg, Gs^Fp, Gg, Aa^Fpa, Re, Gg^Gvs, Gg^Gvs, Xue, Xue, Cer^Fp, Hh, Ww, Ww, Gg
Gg, Aa, Aa, Aa, Aa, Rr, Re, Rr, Rr, Gs^Fp, Gs^Fp, Gg, Gg^Xo, Gg^Xo, Cha, Cha, Cha, Cha, Rr, Cha, Cha, Aa^Xo, Aa^Xo, Aa, Ww, Ww, Gg^Gvs, Gg^Gvs, Gg^Gvs, Gg^Gvs, Aa, Aa, Aa, Aa, Aa, Aa, Aa, Gg, Gs^Fp, Aa^Fpa, Gs^Fp, Gg, Gg, Uhe, Uhe, Gll^Fp, Gll^Fp, Cer^Fp, Cer^Fp, Cer, Gg
Gg, Gg, Gg, Aa, Gg, Gg, Re, Gg, Rr, Gg, Gg, Gg^Xo, Rr^Xo, Cha, Rr, Rr^Vhc, Rr, Rr, Rr^Vhc, Rr, Rr, Cha, Cha, Gg^Xo, Gg^Xo, Ww, Gg^Gvs, Gg^Gvs, Gg^Gvs, Gg^Gvs, Gg^Vh, Aa, Gg, Aa, Aa, Aa, Re, Gg^Esa, Ww, Gs^Fp, Gs^Fp, Ww, Gg, Uhe, Xue, Gll^Fp, Gll^Fp, Gll^Fp, Gll^Fp, Uhe, Gll^Fp
Gg, Gg, Gg, Gg, Re, Re, Gg, Gg, Gg, Rr, Rr, Rr^Xo, Cha, Cha, Cha, Rr, Rr, Rr, Cha, Cha, Cha, Rr, Rr, Cha, Cha, Ww^Xo, Ww, Gg^Gvs, Gg^Gvs, Gg^Esa, Aa, Aa, Aa, Gg, Aa, Aa, Aa, Gg^Esa, Wo, Ww, Wo, Gs^Fp, Qxe, Qxe, Xue, Xue, Xue, Gll^Fp, Xue, Gll^Fp, Xue
Gs^Fp, Gs^Fp, Re, Gg^Vh, Gg^Gvs, Gg, Gg^Gvs, Re, Gg, Rr, Rr, Rr^Xo, Cha, Gg, Cha, Rr, Rr^Vhc, Cha, Kh, 3 Kh, Kh, Cha, Rr^Vhc, Rr, Cha, Gs^Xo, Ww, Gs^Fp, Gg^Gvs, Gg^Gvs, Gg^Esa, Gg^Esa, Aa, Aa, Aa, Aa, Aa, Ww, Wo, Wo, Wo, Wo, Qxe, Xue, Uhe, Uhe, Uhe, Xue, Uhe, Xue, Gg
Gs^Fp, Gs^Fp, Re, Gg^Gvs, Gg^Gvs, Gg^Gvs, Gg^Gvs, Re^Gvs, Gg, Rr, Rr, Rr^Xo, Rr^Xo, Cha, Rr^Vhc, Rr, Rr, Cha, Cha, Kh, Cha, Cha, Rr, Rr, Rr, Rr, Ww, Gg^Gvs, Gg, Gs^Fp, Gg, Gg^Esa, Aa, Aa, Aa, Aa, Aa, Wo, Aa, Wo, Wo, Wo, Gs^Fp, Gs^Fp, Gs^Fp, Gg, Gs^Fp, Uhe, Gs^Fp, Uhe, Gg
Gs^Fp, Gs^Fp, Re, Gg^Gvs, Gg^Gvs, Re^Gvs, Gg^Gvs, Re^Gvs, Gg, Gg, Rr, Rr, Rr, Cha^Qov, Cha^Qov, Rr, Rr, Rr^Vhc, Rr, Cha, Rr, Rr, Cha, Cha, Cha^Qov, Rr, Rr, Ww, Rr, Gs^Fp, Rr, Gg, Aa, Aa, Aa, Ww, Wo, Aa, Aa, Ww, Ww, Wo, Ww, Gs^Fp, Aa^Fpa, Gs^Fp, Aa^Fpa, Gs^Fp, Gs^Fp, Gs^Fp, Gg
Gs^Fp, Ds, Gs^Fp, Re, Gg^Gvs, Gg^Gvs, Re, Re, Re, Re, Gg, Rr, Rr, Rr, Rr, Rr, Rr, Rr, Rr^Vhc, Rr, Rr, Rr, Cha, Gg, Cha^Qov, Rr, Rr, Ww^Bsb\, Rr, Rr, Rr, Rr, Rr, Rr, Wo, Wo, Wo, Wo, Ww^Bsa|, Ww, Wo, Wo, Wo, Ww, Ww, Ww, Aa^Fpa, Gg, Aa^Fpa, Gs^Fp, Gg
Ds, Ds, Gs^Fp, Re, Re, Re, Gg^Gvs, Aa, Gg, Gg, Aa, Gg, Rr^Vhc, Rr, Rr, Rr, Cha, Rr, Cha, Cha, Cha, Rr^Vhc, Cha, Cha, Rr^Xo, Rr, Gs^Fp, Ww^Bsb\, Rr, Rr, Rr^Vhc, Rr, Rr, Wo^Bsa\, Ww^Bsa\, Ww, Wo, Wo, Isr, Isr, Cha, Isr, Isr, Ww, Ww, Ww, Gs^Fds, Gs^Fp, Gs^Fp, Gs^Fp, Gg
Ds, Gs^Fp, Gs^Fp, Gs^Fp, Gs^Fp, Gs^Fp, Aa, Aa, Aa, Aa, Aa, Gg, Gg, Rr, Rr, Gs^Xo, Rr^Xo, Rr, Cha, Kh, Cha, Rr, Rr^Xo, Rr^Xo, Wo, Ww, Wo, Ww, Wo, Rr, Rr, Rr, Rr, Wo, Wo, Ww^Bsa\, Wo^Bsa\, Isr, Kha, Rr^Vhc, Cha, Cha, Cha, Isr, Ww, Ww, Gs^Fp, Gs^Fp, Gs^Fp, Gs^Fp, Gg
Ds, Ds, Gg, Gs^Fp, Gs^Fp, Gs^Fp, Aa, Aa, Aa, Aa^Fpa, Gs^Fp, Gg, Gg, Rr, Rr, Rr, Gg, Rr^Xo, Rr^Xo, Cha, Rr^Xo, Rr^Xo, Rr, Ww, Wo, Wo, Gg, Wo, Ww, Wo, Ww^Bw|, Wo, Wo, Wo, Wo, Wo, Wo, Isr, Cha, Ww^Ewf, Ww^Ewf, Ww^Ewf, Cha, Isr, Ww, Ww, Gs^Fds, Gs^Fp, Gg, Gs^Fp, Gg
Wo, Ds, Gg^Vh, Gg, Gg, Aa^Fpa, Aa^Fpa, Aa, Aa, Aa^Fpa, Gs^Fp, Aa, Gg, Rr, Rr, Rr, Rr, Gg, Rr, Rr^Xo, Gg, Aa, Gg, Ww, Ww, Ds, Gg^Gvs, Gg^Gvs, Gg^Gvs, Gg^Gvs, Re, Gg^Gvs, Gg^Gvs, Gs^Fp, Wo, Wo, Wo, Isr, Isr, Cha, Cha, Cha, Wo^Bsa\, Isr, Ww, Ww, Gs^Fds, Gs^Fds, Gs^Fds, Gs^Fp, Gg
Wo, Gg, Gg, Gg, Gg, Aa^Fpa, Aa, Aa^Fpa, Aa, Aa, Aa, Gs^Fp, Gg, Gg, Rr, Rr, Rr, Rr, Rr, Rr, Rr, Gg, Gg, Gg, Ww, Ds, Ds, Ds, Gg^Gvs, Gg^Gvs, Gg^Vh, Gg^Gvs, Gg^Gvs, Gs^Fp, Ww, Ww, Wo, Wo, Wo, Isr, Isr, Isr, Wo, Wo^Bsa\, Wo^Bsa\, Ww, Rr, Gs^Fds, Rr, Gg, Gg
Wo, Gg, Gg, Gg, Ds, Aa, Aa, Aa, Aa^Fpa, Aa, Aa^Fpa, Gg, Gg^Vh, Re, Gg, Rr, Rr, Rr, Gs^Fp, Rr, Rr, Rr, Rr, Ds, Ds, Wo, Wo, Wo, Wo, Gg^Gvs, Gg^Gvs, Gg^Gvs, Gg^Gvs, Gg^Gvs, Gs^Fds, Ww, Ww, Ww, Wo, Wo, Wo, Wo, Ww, Ww, Ww, Wo^Bsa\, Rr, Rr, Rr, Rr, Rr
Ds, Gg, Ds, Ds, Ds, Ds, Ds, Aa, Aa, Gs^Fp, Gg, Gg, Re, Gg, Gg, Gs^Fp, Gs^Fp, Gs^Fp, Gs^Fp, Gs^Fp, Gs^Fp, Rr, Gg, Aa, Ds, Ds, Wo, Wo, Wo, Wo, Ww, Gg, Ww, Gg, Gs^Fp, Gs^Fp, Gs^Fds, Ww, Ww, Ww, Ww, Ww, Ww, Ww, Aa^Fda, Aa^Fda, Gg, Rr, Rr, Rr, Rr
Gg, Gg, Gg, Ds, Wo, Wo, Ai, Aa, Gg, Gs^Fp, Gg, Gg, Gg, Re, Re, Gs^Fp, Gll, Gs^Fp, Gs^Fp, Gs^Fp, Gs^Fp, Rr, Gg, Aa, Aa, Aa, Aa, Gg, Ds, Ds, Ds, Ww, Wo, Gs^Fp, Gg, Gs^Fp, Gg^Vh, Gs^Fds, Gs^Fds, Gs^Fds, Gs^Fds, Ww, Gs^Fds, Gs^Fds, Gg, Gg, Gg^Gvs, Gg, Gg^Gvs, Rr, Gg
Gg, Gg, Gs^Fp, Ds, Ds, Wo, Wo, Ww, Ds, Gg, Re, Gg, Gg, Gg, Ds, Ds, Ds, Gs^Fp, Gs^Fp, Gs^Fp, Gs^Fp, Rr, Rr, Aa, Aa, Aa, Aa, Gg, Gg, Gg, Gg, Ww, Ww, Ww, Ww, Gs^Fp, Gg^Gvs, Gg, Gg^Gvs, Gs^Fds, Aa^Fda, Gs^Fds, Aa^Fda, Gs^Fds, Gg^Gvs, Gg^Gvs, Gg^Gvs, Gg^Gvs, Gg^Gvs, Gg, Gg
Gs^Fp, Gs^Fp, Gs^Fp, Gs^Fp, Gs^Fp, Ds, Wo, Ds, Ds, Gg, Gg, Gg, Gg, Gg, Ds, Ds, Ds, Gs^Fp, Gs^Fp, Gs^Fp, Gs^Fp, Rr, Rr, Rr, Rr, Gg, Gg, Gg, Gs^Fp, Gs^Fp, Gs^Fp, Gg, Gg^Gvs, Ww, Ww, Gg^Gvs, Ww, Gg^Gvs, Gg^Gvs, Gg^Gvs, Gg, Gg, Gg^Gvs, Gg^Gvs, Gg^Vh, Gg^Gvs, Gg^Gvs, Gg^Gvs, Gg, Gg, Gg^Gvs
Gs^Fp, Gs^Fp, Gs^Fp, Gs^Fp, Gs^Fp, Ww, Wo, Wo, Ds, Ds, Ds, Ds, Ds, Ds, Ds, Ds, Ds, Gll, Gll, Gll, Gs^Fp, Gg, Gg, Rr, Rr, Rr, Gg, Gg, Gs^Fp, Gs^Fds, Gs^Fp, Gg^Gvs, Gg^Gvs, Gg^Gvs, Gg^Gvs, Ww, Ww^Bw/r, Ds, Gg^Gvs, Ds, Gg^Gvs, Gg, Gg^Gvs, Gg^Gvs, Gg^Gvs, Gg^Gvs, Gg^Gvs, Gg^Gvs, Gg, Gg^Gvs, Gg^Gvs
Gs^Fp, Gg^Ve, Gs^Fp, Gs^Fp, Ds, Ww, Wo, Ww, Ww, Ds, Ds, Ds, Ds, Ds, Wo, Ds, Gg, Gg, Re, Re, Re, Re, Gg, Gg^Vh, Rr, Rr, Rr, Gg, Gg, Gs^Fp, Gg^Gvs, Gg^Gvs, Gg^Gvs, Gg^Gvs, Re, Gg^Vh, Ww, Gg^Gvs, Ds, Gg^Gvs, Gg^Gvs, Ds, Gg^Gvs, Gg^Gvs, Gg^Gvs, Gg^Gvs, Gg^Cov, Gg, Gg^Gvs, Gg^Gvs, Gg
Gs^Fp, Gs^Fp, Gs^Fp, Gs^Fp, Gg, Ds, Wo, Wo, Ww, Ww, Wo, Ww, Ww, Ww, Wo, Ai, Ww, Gg^Gvs, Gg^Gvs, Gg^Gvs, Gg^Gvs, Gg^Gvs, Gg, Gg, Gg, Rr, Rr, Rr, Rr, Gg, Gg, Gg^Gvs, Re, Re, Gg^Gvs, Gg^Gvs, Gg^Gvs, Ww, Ds, Gg^Gvs, Gg^Gvs, Gg^Gvs, Gg^Gvs, Gg^Gvs, Gg^Gvs, Gg^Cov, Gg^Kov, Gg^Cov, Gg^Gvs, Gs^Fp, Gg
Gg, Gs^Fp, Gs^Fp, Gll, Gg, Ds, Wo, Wo, Wo, Wo, Wo, Wo, Wo, Wo, Ds, Ai, Ww, Gg^Gvs, Gg^Gvs, Gg^Gvs, Gg^Gvs, Gg^Gvs, Gg^Gvs, Gg, Gg, Gs^Fp, Gg, Rr, Rr, Rr, Rr, Gg, Gg, Gg^Gvs, Gg^Gvs, Gg^Gvs, Gg, Ww, Gg, Gg^Gvs, Gs^Fp, Gg^Gvs, Gg, Gg^Gvs, Gg^Gvs, Gg^Cov, Gg^Cov, Gg^Cov, Gs^Fp, Gs^Fp, Gg
Hh, Gs^Fp, Gll, Gll, Gg, Gg^Gvs, Ds, Ds, Ds, Ds, Ds, Ds, Ds, Aa, Aa, Ww, Aa, Gg^Gvs, Gg^Gvs, Gg^Gvs, Gg^Gvs, Gg^Gvs, Gg, Gg, Gg, Gg, Gg, Gg, Rr, Rr, Rr, Gs^Fp, Gs^Fp, Gs^Fp, Gs^Fds, Gs^Fp, Ww, Ww, Ww, Gs^Fp, Gs^Fp, Gs^Fp, Gg, Gg^Gvs, Gs^Fp, Gg^Gvs, Gs^Fp, Gs^Fp, Gs^Fp, Gs^Fp, Gg
Gg, Gs^Fp, Gll, Gs^Fp, Gg, Gg^Gvs, Gg^Gvs, Gg^Gvs, Ds^Gvs, Ds, Gg^Gvs, Gg^Gvs, Gg, Gg, Gg, Ww, Ww, Aa, Gg^Gvs, Gg^Gvs, Gg^Gvs, Gg^Gvs, Gg, Gs^Fp, Gs^Fp, Gs^Fp, Gg, Gg, Gs^Fp, Rr, Rr, Gs^Fp, Gs^Fds, Gs^Fp, Gs^Fp, Gg, Ww, Ww, Ww, Gs^Fp, Gs^Fp, Gs^Fp, Gs^Fp, Gs^Fp, Gs^Fp, Gs^Fp, Gs^Fp, Gs^Fp, Gs^Fp, Gs^Fp, Gg
Gs^Fp, Gs^Fp, Gll, Gs^Fp, Gg^Gvs, Gg^Gvs, Gg^Gvs, Gg^Gvs, Gg^Gvs, Gg^Gvs, Gg^Gvs, Gg^Gvs, Gg^Gvs, Gg^Vh, Ww, Ww, Wo, Ww, Gg^Gvs, Gg^Gvs, Gg^Gvs, Gg^Gvs, Gs^Fp, Gs^Fp, Gs^Fp, Gs^Fp, Gs^Fp, Gs^Fp, Gs^Fp, Gs^Fp, Gs^Fp, Rr, Gs^Fp, Gs^Ft, Gs^Fp, Gs^Fp, Gs^Fp, Gg, Ww, Gs^Fp, Gs^Fp, Gg, Gs^Fp, Gs^Fp, Gs^Fp, Gs^Fp, Gs^Fp, Gs^Fp, Gs^Fp, Gs^Fp, Gg
Gg, Gs^Fp, Gll, Gg, Gg, Gg, Gg, Gg, Gs^Fp, Gs^Fp, Gg^Gvs, Gg^Gvs, Gg^Gvs, Ww, Wo, Wo, Wo, Ww, Ww, Gg^Gvs, Gg^Gvs, Gg^Gvs, Gg^Gvs, Gg, Gs^Fp, Gs^Fp, Gs^Fp, Gs^Fp, Gs^Ft, Gs^Fp, Gs^Fp, Rr, Gg^Vh, Gg, Gs^Fp, Gs^Ft, Gs^Fp, Gg, Ww, Gs^Fp, Gg, Gg, Gs^Fp, Gs^Fp, Gs^Fp, Gg^Ve, Gs^Fp, Gs^Fp, Gs^Fp, Gs^Fp, Gg
Gg, Gs^Fp, Gll, Gll, Gg, Gs^Fp, Re, Gs^Fds, Gs^Fds, Gs^Fp, Gg^Gvs, Gg^Gvs, Gg^Gvs, Ww^Gvs, Ww, Wo, Ww, Ww, Ww, Gg, Gg^Gvs, Gg^Gvs, Gg, Gs^Fds, Gs^Fp, Gs^Fp, Gs^Fp, Gs^Fds, Gs^Ft, Gg, Gg, Rr, Rr, Gg, Gs^Fp, Gs^Fp, Gs^Fp, Gs^Fp, Ww, Gs^Fp, Gg, Gg, Gs^Fp, Gs^Fp, Gs^Fp, Gs^Fp, Gs^Fp, Gs^Fp, Gs^Fp, Gs^Fp, Gs^Fp
Gg, Gs^Fp, Gll, Gs^Fp, Gs^Fp, Gg, Gs^Fp, Gs^Fp, Gs^Fds, Gg, Gg^Gvs, Gg^Gvs, Gg^Gvs, Gg^Gvs, Hh, Ww, Ww, Gg, Gg^Gvs, Gg^Gvs, Gg^Gvs, Gg^Gvs, Gg^Gvs, Gs^Ft, Gs^Fp, Gs^Fds, Gs^Fp, Gs^Fp, Gs^Fp, Gs^Fp, Gg, Gg, Rr, Gg, Gs, Gs^Fp, Gs^Fp, Gs^Fp, Ww, Ww, Ww, Gg, Gg, Gg, Gg, Gs^Fp, Gs^Fp, Gs^Fp, Gs^Fp, Gs^Fp, Gs^Fp
Gg, Gg^Vh, Gs^Fp, Gs^Fp, Gs^Fp, Gs^Fp, Gs^Fp, Gs^Fds, Gg, Gg, Gg, Gg, Gg, Gg, Gg, Hh, Aa, Gg^Gvs, Gg^Gvs, Gg^Gvs, Gg^Gvs, Gg^Gvs, Gg^Gvs, Gs^Fp, Gs^Ft, Gs^Fp, Gs^Fp, Gg^Ve, Gs^Fp, Gs, Gg, Ch, Ch, Ch, Gs^Fp, Gs^Fp, Gs^Fp, Gs^Fp, Gs^Fp, Gs^Fp, Gg, Ww, Ww, Gg, Ww, Gs^Fp, Gs^Fp, Gs^Fp, Gs^Fp, Gs^Fp, Gs^Fp
Gg, Gs^Fp, Gs^Fp, Gs^Fp, Gs^Fp, Gg, Gs^Fp, Aa, Gg, Gg, Gg, Gg^Wm, Gg, Gg, Aa, Aa, Aa, Aa, Gg, Gg, Gg, Gg^Gvs, Gg, Gs^Ft, Gs^Fp, Gs^Fp, Gs^Fp, Gs^Fp, Gs^Fp, Gg, Gs, Ch, 2 Kh, Ch, Gg, Gs^Fp, Gs^Fp, Gs^Fp, Gs^Fp, Gg, Ww, Ww, Gg, Ww, Gg, Gs^Fp, Ww, Gs^Fp, Gs^Fp, Gs^Fp, Gs^Fp
Gg, Aa, Gg, Gg, Gg, Gs^Fp, Aa^Cov, Aa^Cov, Aa^Cov, Gg, Gg, Gg, Gg, Gg, Aa, Aa, Aa, Aa, Gg, Gg, Gg^Vh, Gg, Gs^Ft, Gs^Fp, Gs^Fp, Gs^Ft, Gs^Fp, Gs^Fp, Gs^Fp, Gg, Ch, Ch, Ch, Gg, Gs^Fp, Hh, Gs^Fp, Gs^Fp, Gg, Gg, Ww, Ww, Gg, Gg, Gg, Gg, Gg, Ww, Ww, Gs^Fp, Gs^Fp
Gg, Gs^Fp, Gs^Fp, Hh, Hh, Aa^Fpa, Aa^Cov, Aa^Kov, Aa^Cov, Aa^Vha, Aa, Gg, Gg, Gg, Aa, Aa, Aa, Aa, Gg, Gg, Gg, Gs^Fp, Gg, Gs^Fp, Gg, Gs^Fp, Gs^Fp, Gs^Fp, Gs^Fp, Gg, Rr, Rr, Rr, Gg, Gs^Fp, Gs^Fp, Gg, Gg, Ww, Ww, Gg, Ww, Gg, Gg, Gg, Gg, Gg, Ww, Ww, Ww, Ww
Gg, Gs^Fp, Gs^Fp, Gg, Hh, Aa^Fpa, Aa, Aa^Cov, Aa, Aa^Fpa, Gg, Gg, Gg, Gg, Aa^Fpa, Aa, Aa, Aa, Gg, Aa, Aa, Aa, Aa, Aa, Aa, Gs^Fp, Gs^Fp, Gs^Fp, Rr, Rr, Rr, Rr, Gg, Gs^Fp, Gg, Gs^Fp, Ww, Ww, Gg, Gg, Gg, Ww, Ww, Gg, Gg, Gg, Gg, Gg, Gg, Gg, Gg
Gg, Gs^Fp, Gs^Fp, Gs^Fp, Gs^Fp, Aa, Aa, Aa^Fpa, Aa, Gg, Gg, Gg, Gg, Gg, Gg, Aa^Fpa, Gg, Gg, Gg, Aa, Aa, Aa, Aa, Aa, Aa, Gg, Gg, Gs^Fp, Rr, Rr, Gg, Gg, Gs^Fp, Gg, Gs^Fp, Gg, Ww, Ww, Gg, Gg, Gg, Ww, Ww, Gg, Gg, Gg, Gg, Gg^Vh, Gg, Gg, Gg
Gs^Fp, Gs^Fp, Gg, Gs^Fp, Aa, Aa, Gg, Gg, Aa, Aa, Gg, Gg, Gg, Aa, Aa, Gg, Gg, Gg, Gg, Gg, Gg, Gg, Gg, Aa, Aa, Gg, Gg, Rr, Gg, Rr, Gg, Gs^Fp, Gs^Fp, Gs^Fp, Gs^Fp, Gs^Fp, Gs^Fp, Ww, Gs^Fp, Gg, Gg, Ww, Ww, Ww, Gg, Gg, Gg, Gg, Gg, Gg, Gg
