Iwr, Iwr, Iwr, Iwr, Xoa, Iwr, Iwr, Iwr, Xoa, Iwr, Iwr, Iwr, Iwr, Iwr, Iwr, Iwr, Xoa, Iwr, Iwr, Iwr, Iwr, Iwr, Iwr, Iwr, Xoa, Iwr, Iwr, Iwr, Iwr, Iwr, Xoa, Iwr
Iwr, Iwr, Iwr, Iwr, Xoa^Efs, Iwr, Iwr, Iwr, Xoa^Efs, Iwr, Iwr, Iwr, Iwr, Xoa, Iwr, Iwr, Xoa, Iwr, Iwr, Iwr, Iwr, Iwr, Xoa^Efs, Xoa, Xoa, Iwr, Iwr, Iwr, Xoa, Rr^Pr|o, Iwr, Iwr
Iwr, Xoa, Xoa, Xoa, Iwr^Efs, Xoa, Xoa, Xoa, Iwr, Xoa, Xoa, Xoa, Iwr, Xoa^Efs, Xoa, Iwr, Xoa, Iwr, Iwr, Iwr, Xoa, Xoa, Iwr, Iwr, Iwr, Xoa, Xoa, Xoa^Efs, Iwr, Iwr, Xoa, Xoa
Iwr, Iwr, Xoa, Iwr, Iwr, Iwr, Xoa, Iwr, Iwr, Iwr, Xoa, Iwr, Iwr, Iwr, Xoa, Xoa^Efs, Iwr, Iwr, Iwr, Iwr, Xoa, Iwr, Iwr, Iwr, Iwr, Xoa, Iwr, Iwr, Xoa, Xoa, Iwr, Iwr
Iwr, Iwr, Xoa, Iwr, Iwr, Iwr, Rr^Pr|o, Xoa, Xoa, Rr^Pr|o, Iwr, Iwr, Rr^Pr|o, Xoa, Iwr, Iwr, Iwr, Iwr, Iwr, Iwr, Iwr, Xoa, Rr^Pr|o, Iwr, Iwr, Iwr, Iwr, Xoa, Xoa, Iwr, Iwr, Iwr
Iwr, Xoa, Iwr, Xoa^Efs, Xoa, Xoa, Iwr, Iwr, Iwr, Iwr, Xoa, Xoa, Iwr, Iwr, Iwr, Iwr, Iwr, Iwr, Xof, Iwr, Iwr, Iwr, Iwr, Xoa, Xoa^Efs, Iwr, Iwr, Iwr, Iwr, Xoa, Xoa, Iwr
Iwr, Iwr, Iwr, Iwr, Xoa, Iwr, Iwr, Iwr, Xoa, Xoa^Efs, Iwr, Iwr, Iwr, Iwr, Iwr, Iwr, Xof, Xof^Efs, Irs, Xof, Xof, Iwr, Iwr, Iwr, Iwr, Xoa, Xoa, Iwr, Iwr, Iwr, Iwr, Xoa
Iwr, Iwr, Iwr, Iwr, Iwr, Iwr, Xoa^Efs, Xoa, Iwr, Iwr, Iwr, Iwr, Iwr, Iwr, Xof, Rr^Pr|o, Irs, Irs, Ww^Ewf, Irs, Irs, Xof^Efs, Xof, Iwr, Iwr, Iwr, Iwr, Xoa^Efs, Xoa, Iwr, Xoa, Xoa
Xoa, Iwr, Xoa, Xoa, Xoa, Xoa, Iwr, Iwr, Xoa, Iwr, Iwr, Iwr, Xof, Xof^Efs, Irs, Irs, Ww^Ewf, Ww^Ewf, Ww^Ewl, Ww^Ewf, Ww^Ewf, Irs, Irs, Xof, Xof, Iwr, Iwr, Iwr, Iwr, Xoa, Iwr, Iwr
Iwr, Xoa^Efs, Iwr, Iwr, Iwr, Iwr, Iwr, Xoa, Xoa, Xoa, Iwr, Iwr, Xof, Irs, Irs, Ww^Ewf, Ww^Ewf, Ww^Ewl, Ww^Ewf, Ww^Ewl, Ww^Ewf, Ww^Ewf, Ww^Ewf, Irs, Irs, Xof, Xof, Iwr, Iwr, Iwr, Iwr, Iwr
Iwr, Iwr, Iwr, Iwr, Xoa, Iwr, Iwr, Iwr, Iwr, Iwr, Iwr, Iwr, Iwr, Xof, Xof^Efs, Irs, Irs, Ww^Ewf, Ww^Ewf, Ww^Ewf, Ww^Ewf, Ww^Ewf, Irs, Irs, Xof, Xof, Iwr, Iwr, Iwr, Iwr, Xoa, Xoa
Iwr, Iwr, Xoa, Xoa^Efs, Iwr, Rr^Pr|o, Xoa^Efs, Iwr, Iwr, Iwr, Xoa^Efs, Iwr, Iwr, Iwr, Iwr, Xof, Xof^Efs, Irs, Irs, Ww^Ewf, Irs, Irs, Xof, Xof, Iwr, Iwr, Iwr, Iwr, Xoa, Xoa, Iwr, Iwr
Iwr, Iwr, Xoa, Iwr, Iwr, Iwr, Iwr, Xoa, Xoa, Xoa, Iwr^Efs, Rr^Pr|o, Xoa, Iwr, Iwr, Iwr, Iwr, Xof, Xof, Irs, Xof, Xof, Iwr, Iwr, Iwr, Iwr, Xoa, Rr^Pr|o, Iwr, Iwr, Iwr, Iwr
Iwr, Iwr, Xoa^Efs, Iwr, Iwr, Iwr, Iwr, Iwr, Xoa, Iwr, Iwr, Iwr, Iwr, Xoa, Iwr, Iwr, Iwr, Iwr, Iwr, Xof, Iwr, Iwr, Iwr, Iwr, Xoa, Xoa, Iwr, Iwr, Iwr, Iwr, Xoa^Efs, Xoa
Iwr, Iwr, Xoa, Iwr, Iwr, Iwr, Iwr, Iwr, Xoa, Iwr, Iwr, Iwr, Iwr, Xoa, Iwr, Iwr, Xoa, Iwr, Iwr, Iwr, Iwr, Iwr, Iwr, Xoa, Iwr, Iwr, Iwr, Iwr, Xoa, Xoa, Iwr, Iwr
Iwr, Iwr, Xoa, Iwr, Iwr, Iwr, Iwr, Iwr, Xoa, Iwr, Iwr, Iwr, Iwr, Xoa, Iwr, Xoa, Iwr, Rr^Pr|o, Xoa, Iwr, Iwr, Iwr, Iwr, Xoa, Iwr, Iwr, Xoa, Rr^Pr|o, Iwr, Iwr, Iwr, Iwr
Iwr, Iwr, Xoa, Iwr, Iwr, Iwr, Iwr, Iwr, Xoa, Iwr, Rr^Pr|o, Iwr, Iwr, Xoa, Iwr, Xoa^Efs, Iwr, Iwr, Iwr, Xoa, Iwr, Iwr, Iwr, Xoa, Xoa^Efs, Xoa, Iwr, Iwr, Iwr, Iwr, Xoa^Efs, Iwr
Iwr, Iwr, Xoa, Iwr, Iwr, Iwr, Iwr, Iwr, Xoa, Xoa^Efs, Iwr, Xoa, Xoa^Efs, Xoa, Iwr, Xoa^Efs, Xoa, Iwr, Iwr, Xoa, Iwr, Iwr, Iwr, Xoa, Iwr, Iwr, Iwr, Iwr, Xoa, Xoa, Iwr, Iwr
Iwr, Iwr, Xoa, Iwr, Iwr, Iwr, Iwr, Iwr, Xoa, Iwr, Iwr, Iwr, Xoa, Iwr, Iwr, Iwr, Iwr, Xoa, Xoa, Xoa, Iwr, Iwr, Iwr, Xoa, Iwr, Iwr, Xoa^Efs, Xoa, Xoa, Iwr, Iwr, Iwr
Iwr, Iwr, Iwr, Xoa, Xoa, Iwr, Xoa, Xoa^Efs, Iwr, Xoa, Rr^Pr|o, Iwr, Rr^Pr|o, Xoa, Xoa, Iwr, Iwr, Iwr, Iwr, Xoa, Iwr, Iwr, Iwr, Xoa, Xoa, Xoa, Iwr, Iwr, Iwr, Xoa^Efs, Rr^Pr|o, Iwr
Iwr, Iwr, Iwr, Iwr, Iwr, Xoa, Iwr, Iwr, Iwr, Iwr, Iwr, Xoa, Iwr, Iwr, Iwr, Xoa, Iwr, Iwr, Iwr, Xoa, Iwr, Iwr, Iwr, Xoa, Iwr, Iwr, Iwr, Iwr, Iwr, Iwr, Iwr, Iwr
Iwr, Iwr, Iwr, Iwr, Iwr, Xoa, Iwr, Iwr, Iwr, Iwr, Iwr, Xoa, Iwr, Iwr, Iwr, Xoa, Iwr, Iwr, Iwr, Xoa, Iwr, Iwr, Iwr, Xoa, Iwr, Iwr, Iwr, Iwr, Iwr, Iwr, Iwr, Iwr
