Iwr, Iwr, Iwr, Iwr, Xoa, Iwr, Iwr, Iwr, Xoa, Iwr, Iwr, Iwr, Iwr, Iwr, Iwr, Iwr, Xoa, Iwr, Iwr, Iwr, Iwr, Iwr, Iwr, Iwr, Xoa, Iwr, Iwr, Iwr, Iwr, Iwr, Xoa, Iwr
Iwr, Iwr, Iwr, Iwr, Xoa^Efs, Iwr, Iwr, Iwr, Xoa^Efs, Iwr, Iwr, Iwr, Iwr, Xoa, Iwr, Iwr, Xoa, Iwr, Iwr, Iwr, Iwr, Iwr, Xoa^Efs, Xoa, Xoa, Iwr, Iwr, Iwr, Xoa, Rr^Pr|o, Iwr, Iwr
Iwr, Xoa, Xoa, Xoa, Iwr^Efs, Xoa, Xoa, Xoa, Iwr, Xoa, Xoa, Xoa, Iwr, Xoa^Efs, Xoa, Iwr, Xoa, Iwr, Iwr, Iwr, Xoa, Xoa, Iwr, Iwr, Iwr, Xoa, Xoa, Xoa^Efs, Iwr, Iwr, Xoa, Xoa
Iwr, Iwr, Xoa, Iwr, Iwr, Iwr, Xoa, Iwr, Iwr, Iwr, Xoa, Iwr, Iwr, Iwr, Xoa, Xoa^Efs, Iwr, Iwr, Iwr, Iwr, Xoa, Iwr, Iwr, Iwr, Iwr, Xoa, Iwr, Iwr, Xoa, Xoa, Iwr, Iwr
Iwr, Iwr, Xoa, Iwr, Iwr, Iwr, Rr^Pr|o, Xoa, Xoa, Rr^Pr|o, Iwr, Iwr, Rr^Pr|o, Xoa, Iwr, Iwr, Iwr, Iwr, Iwr, Iwr, Iwr, Xoa, Rr^Pr|o, Iwr, Iwr, Iwr, Iwr, Xoa, Xoa, Iwr, Iwr, Iwr
Iwr, Xoa, Iwr, Xoa^Efs, Xoa, Xoa, Iwr, Iwr, Iwr, Iwr, Xoa, Xoa, Iwr, Iwr, Iwr, Iwr, Iwr, Iwr, Xof, Iwr, Iwr, Iwr, Iwr, Xoa, Xoa^Efs, Iwr, Iwr, Iwr, Iwr, Xoa, Xoa, Iwr
Iwr, Iwr, Iwr, Iwr, Xoa, Iwr, Iwr, Iwr, Xoa, Xoa^Efs, Iwr, Iwr, Iwr, Iwr, Iwr, Iwr, Xof, Xof^Efs, Isr, Xof, Xof, Iwr, Iwr, Iwr, Iwr, Xoa, Xoa, Iwr, Iwr, Iwr, Iwr, Xoa
Iwr, Iwr, Iwr, Iwr, Iwr, Iwr, Xoa^Efs, Xoa, Iwr, Iwr, Iwr, Iwr, Iwr, Iwr, Xof, Rr^Pr|o, Isr, Isr, Ww^Ewf, Isr, Isr, Xof^Efs, Xof, Iwr, Iwr, Iwr, Iwr, Xoa^Efs, Xoa, Iwr, Xoa, Xoa
Xoa, Iwr, Xoa, Xoa, Xoa, Xoa, Iwr, Iwr, Xoa, Iwr, Iwr, Iwr, Xof, Xof^Efs, Isr, Isr, Ww^Ewf, Ww^Ewf, Ww^Ewl, Ww^Ewf, Ww^Ewf, Isr, Isr, Xof, Xof, Iwr, Iwr, Iwr, Iwr, Xoa, Iwr, Iwr
Iwr, Xoa^Efs, Iwr, Iwr, Iwr, Iwr, Iwr, Xoa, Xoa, Xoa, Iwr, Iwr, Xof, Isr, Isr, Ww^Ewf, Ww^Ewf, Ww^Ewl, Ww^Ewf, Ww^Ewl, Ww^Ewf, Ww^Ewf, Ww^Ewf, Isr, Isr, Xof, Xof, Iwr, Iwr, Iwr, Iwr, Iwr
Iwr, Iwr, Iwr, Iwr, Xoa, Iwr, Iwr, Iwr, Iwr, Iwr, Iwr, Iwr, Iwr, Xof, Xof^Efs, Isr, Isr, Ww^Ewf, Ww^Ewf, Ww^Ewf, Ww^Ewf, Ww^Ewf, Isr, Isr, Xof, Xof, Iwr, Iwr, Iwr, Iwr, Xoa, Xoa
Iwr, Iwr, Xoa, Xoa^Efs, Iwr, Rr^Pr|o, Xoa^Efs, Iwr, Iwr, Iwr, Xoa^Efs, Iwr, Iwr, Iwr, Iwr, Xof, Xof^Efs, Isr, Isr, Ww^Ewf, Isr, Isr, Xof, Xof, Iwr, Iwr, Iwr, Iwr, Xoa, Xoa, Iwr, Iwr
Iwr, Iwr, Xoa, Iwr, Iwr, Iwr, Iwr, Xoa, Xoa, Xoa, Iwr^Efs, Rr^Pr|o, Xoa, Iwr, Iwr, Iwr, Iwr, Xof, Xof, Isr, Xof, Xof, Iwr, Iwr, Iwr, Iwr, Xoa, Rr^Pr|o, Iwr, Iwr, Iwr, Iwr
Iwr, Iwr, Xoa^Efs, Iwr, Iwr, Iwr, Iwr, Iwr, Xoa, Iwr, Iwr, Iwr, Iwr, Xoa, Iwr, Iwr, Iwr, Iwr, Iwr, Xof, Iwr, Iwr, Iwr, Iwr, Xoa, Xoa, Iwr, Iwr, Iwr, Iwr, Xoa^Efs, Xoa
Iwr, Iwr, Xoa, Iwr, Iwr, Iwr, Iwr, Iwr, Xoa, Iwr, Iwr, Iwr, Iwr, Xoa, Iwr, Iwr, Xoa, Iwr, Iwr, Iwr, Iwr, Iwr, Iwr, Xoa, Iwr, Iwr, Iwr, Iwr, Xoa, Xoa, Iwr, Iwr
Iwr, Iwr, Xoa, Iwr, Iwr, Iwr, Iwr, Iwr, Xoa, Iwr, Iwr, Iwr, Iwr, Xoa, Iwr, Xoa, Iwr, Rr^Pr|o, Xoa, Iwr, Iwr, Iwr, Iwr, Xoa, Iwr, Iwr, Xoa, Rr^Pr|o, Iwr, Iwr, Iwr, Iwr
Iwr, Iwr, Xoa, Iwr, Iwr, Iwr, Iwr, Iwr, Xoa, Iwr, Rr^Pr|o, Iwr, Iwr, Xoa, Iwr, Xoa^Efs, Iwr, Iwr, Iwr, Xoa, Iwr, Iwr, Iwr, Xoa, Xoa^Efs, Xoa, Iwr, Iwr, Iwr, Iwr, Xoa^Efs, Iwr
Iwr, Iwr, Xoa, Iwr, Iwr, Iwr, Iwr, Iwr, Xoa, Xoa^Efs, Iwr, Xoa, Xoa^Efs, Xoa, Iwr, Xoa^Efs, Xoa, Iwr, Iwr, Xoa, Iwr, Iwr, Iwr, Xoa, Iwr, Iwr, Iwr, Iwr, Xoa, Xoa, Iwr, Iwr
Iwr, Iwr, Xoa, Iwr, Iwr, Iwr, Iwr, Iwr, Xoa, Iwr, Iwr, Iwr, Xoa, Iwr, Iwr, Iwr, Iwr, Xoa, Xoa, Xoa, Iwr, Iwr, Iwr, Xoa, Iwr, Iwr, Xoa^Efs, Xoa, Xoa, Iwr, Iwr, Iwr
Iwr, Iwr, Iwr, Xoa, Xoa, Iwr, Xoa, Xoa^Efs, Iwr, Xoa, Rr^Pr|o, Iwr, Rr^Pr|o, Xoa, Xoa, Iwr, Iwr, Iwr, Iwr, Xoa, Iwr, Iwr, Iwr, Xoa, Xoa, Xoa, Iwr, Iwr, Iwr, Xoa^Efs, Rr^Pr|o, Iwr
Iwr, Iwr, Iwr, Iwr, Iwr, Xoa, Iwr, Iwr, Iwr, Iwr, Iwr, Xoa, Iwr, Iwr, Iwr, Xoa, Iwr, Iwr, Iwr, Xoa, Iwr, Iwr, Iwr, Xoa, Iwr, Iwr, Iwr, Iwr, Iwr, Iwr, Iwr, Iwr
Iwr, Iwr, Iwr, Iwr, Iwr, Xoa, Iwr, Iwr, Iwr, Iwr, Iwr, Xoa, Iwr, Iwr, Iwr, Xoa, Iwr, Iwr, Iwr, Xoa, Iwr, Iwr, Iwr, Xoa, Iwr, Iwr, Iwr, Iwr, Iwr, Iwr, Iwr, Iwr
